CustomerID,Recency,Frequency,Monetary,R,F,M,RFM_Score
12346,326,1,77183.6,1,1,4,6
12347,2,6,3598.2100000000005,4,4,4,12
12348,75,3,784.44,2,3,3,8
12349,19,1,1457.5500000000002,3,1,3,7
12350,310,1,294.40000000000003,1,1,1,3
12352,36,7,1385.7400000000002,3,4,3,10
12353,204,1,89.0,1,1,1,3
12354,232,1,1079.3999999999999,1,1,3,5
12355,214,1,459.4,1,1,2,4
12356,23,3,2487.43,3,3,4,10
12357,33,1,6207.67,3,1,4,8
12358,2,2,928.06,4,2,3,9
12359,58,4,6310.030000000001,2,3,4,9
12360,52,3,2302.0600000000004,2,3,4,9
12361,287,1,174.89999999999998,1,1,1,3
12362,3,10,4737.2300000000005,4,4,4,12
12364,8,4,1208.1,4,3,3,10
12365,291,1,320.68999999999994,1,1,2,4
12367,4,1,150.89999999999998,4,1,1,6
12370,51,2,1677.6699999999998,2,2,4,8
12371,60,1,1527.96,2,1,3,6
12372,72,3,1196.04,2,3,3,8
12373,311,1,324.6,1,1,2,4
12374,25,1,622.93,3,1,2,6
12375,11,2,377.50000000000006,4,2,2,8
12377,315,1,546.6,1,1,2,4
12378,130,1,4008.62,1,1,4,6
12379,82,2,777.2399999999998,2,2,3,7
12380,22,4,2427.81,3,3,4,10
12381,5,3,1474.81,4,3,3,10
12383,185,4,1072.84,1,3,3,7
12384,29,2,425.27,3,2,2,7
12386,338,1,143.0,1,1,1,3
12388,16,6,2780.6600000000003,4,4,4,12
12390,80,1,504.8400000000001,2,1,2,5
12391,22,1,439.66,3,1,2,6
12393,72,4,1582.6000000000001,2,3,3,8
12394,64,2,1080.48,2,2,3,7
12395,19,10,2092.7099999999996,3,4,4,11
12397,36,2,2214.9000000000005,3,2,4,9
12398,46,1,1435.6599999999999,3,1,3,7
12399,119,4,1033.65,2,3,3,8
12401,303,1,69.3,1,1,1,3
12402,323,1,195.6,1,1,1,3
12403,50,1,391.7,2,1,2,5
12405,149,1,1390.3900000000003,1,1,3,5
12406,22,2,3415.3,3,2,4,9
12407,50,5,1507.1200000000001,2,4,3,9
12408,33,5,2618.5499999999997,3,4,4,11
12409,79,3,11072.67,2,3,4,9
12410,309,2,533.3299999999999,1,2,2,5
12412,75,3,1142.88,2,3,3,8
12413,67,3,686.1,2,3,3,8
12414,217,3,442.41,1,3,2,6
12415,24,20,124564.53,3,4,4,11
12417,3,8,2964.7599999999998,4,4,4,12
12418,113,1,668.58,2,1,3,6
12420,64,1,600.3900000000001,2,1,2,5
12421,16,4,639.0400000000001,4,3,2,9
12422,96,3,683.5599999999998,2,3,3,8
12423,1,7,1441.38,4,4,3,11
12424,163,2,1760.9599999999996,1,2,4,7
12425,78,1,777.1999999999999,2,1,3,6
12426,195,1,510.72999999999996,1,1,2,4
12427,22,2,450.3,3,2,2,7
12428,26,8,6405.26,3,4,4,11
12429,9,3,2250.9,4,3,4,11
12430,43,1,216.4,3,1,1,5
12431,36,13,5608.5,3,4,4,11
12432,43,4,4359.319999999999,3,3,4,10
12433,1,5,9588.75,4,4,4,12
12434,85,2,806.14,2,2,3,7
12435,80,2,7829.890000000001,2,2,4,8
12436,100,1,429.01,2,1,2,5
12437,2,18,4447.41,4,4,4,12
12438,14,2,2466.85,4,2,4,10
12442,3,1,144.06,4,1,1,6
12444,21,5,4085.46,3,4,4,11
12445,22,1,77.4,3,1,1,5
12446,58,1,1002.3100000000001,2,1,3,6
12447,243,1,431.49,1,1,2,4
12448,44,1,365.4500000000001,3,1,2,6
12449,22,4,3596.29,3,3,4,10
12450,156,2,197.88,1,2,1,4
12451,11,5,8995.52,4,4,4,12
12452,17,1,348.57,4,1,2,7
12453,134,1,707.0899999999999,1,1,3,5
12454,56,1,3528.34,2,1,4,7
12455,73,5,2339.8599999999988,2,4,4,10
12456,44,3,2581.04,3,3,4,10
12457,66,6,2043.2299999999996,2,4,4,10
12458,71,2,787.4000000000001,2,2,3,7
12461,155,1,626.88,1,1,2,4
12462,19,2,937.59,3,2,3,8
12463,53,4,1200.78,2,3,3,8
12464,10,8,957.0499999999998,4,4,3,11
12465,17,2,682.19,4,2,3,9
12468,188,2,657.54,1,2,3,6
12471,2,24,14125.689999999999,4,4,4,12
12472,32,6,4544.81,3,4,4,11
12473,54,3,2585.73,2,3,4,9
12474,17,18,6694.09,4,4,4,12
12475,54,1,669.3799999999999,2,1,3,6
12476,16,10,5885.969999999999,4,4,4,12
12477,23,6,13219.740000000002,3,4,4,11
12478,4,1,545.9900000000001,4,1,2,7
12479,11,1,473.20000000000005,4,1,2,7
12480,28,4,2885.63,3,3,4,10
12481,23,8,4338.48,3,4,4,11
12483,17,8,1910.9800000000002,4,4,4,12
12484,35,4,3939.3199999999997,3,3,4,10
12488,10,3,1244.6600000000003,4,3,3,10
12489,336,1,298.93,1,1,1,3
12490,5,10,4859.93,4,4,4,12
12491,39,1,424.40000000000003,3,1,2,6
12492,63,2,227.21000000000004,2,2,1,5
12493,166,2,379.74,1,2,2,5
12494,16,5,1039.5499999999997,4,4,3,11
12497,82,1,953.1,2,1,3,6
12498,21,3,349.7,3,3,2,8
12500,23,11,4059.8200000000006,3,4,4,11
12501,337,1,2025.39,1,1,4,6
12502,96,5,2995.87,2,4,4,10
12504,18,2,428.04999999999995,3,2,2,7
12506,233,1,73.50000000000001,1,1,1,3
12507,134,3,1052.81,1,3,3,7
12508,26,2,397.88,3,2,2,7
12509,284,1,158.5,1,1,1,3
12510,143,2,814.57,1,2,3,6
12512,66,2,132.18,2,2,1,5
12513,113,1,558.2900000000001,2,1,2,5
12514,267,1,1017.6800000000001,1,1,3,5
12516,78,2,1186.06,2,2,3,7
12517,28,4,2301.6,3,3,4,10
12518,1,5,1840.8899999999999,4,4,4,12
12519,64,1,276.84000000000003,2,1,1,4
12520,79,5,2346.26,2,4,4,10
12521,143,1,545.68,1,1,2,4
12522,39,2,156.72000000000003,3,2,1,6
12523,19,11,1699.77,3,4,4,11
12524,9,8,3945.7200000000003,4,4,4,12
12526,1,3,1172.6600000000003,4,3,3,10
12527,82,3,330.71,2,3,2,7
12528,9,6,1645.48,4,4,4,12
12530,60,4,1500.2800000000002,2,3,3,8
12531,15,1,125.22,4,1,1,6
12532,30,1,313.83,3,1,2,6
12534,131,1,981.1800000000001,1,1,3,5
12535,92,2,716.35,2,2,3,7
12536,59,1,4279.71,2,1,4,7
12538,29,1,363.95,3,1,2,6
12539,22,4,5568.349999999999,3,3,4,10
12540,20,16,10839.23,3,4,4,11
12541,30,3,841.18,3,3,3,9
12544,36,1,316.70000000000005,3,1,2,6
12545,75,2,832.39,2,2,3,7
12546,47,2,1021.5,3,2,3,8
12547,198,2,151.8,1,2,1,4
12548,166,1,67.19999999999999,1,1,1,3
12550,79,1,824.8299999999999,2,1,3,6
12552,40,1,317.82,3,1,2,6
12553,8,10,3278.2799999999997,4,4,4,12
12556,50,2,599.56,2,2,2,6
12557,16,4,11370.96,4,3,4,11
12558,8,1,269.96000000000004,4,1,1,6
12559,311,2,525.7099999999999,1,2,2,5
12560,5,2,1918.0100000000002,4,2,4,10
12561,303,1,238.85,1,1,1,3
12562,8,7,3385.74,4,4,4,12
12564,261,1,402.90000000000003,1,1,2,4
12565,289,1,145.92000000000002,1,1,1,3
12566,86,1,297.65,2,1,1,4
12567,23,8,6882.9,3,4,4,11
12569,2,32,3152.69,4,4,4,12
12571,40,2,519.61,3,2,2,7
12572,9,2,912.4199999999998,4,2,3,9
12573,227,1,160.54,1,1,1,3
12574,316,1,182.45000000000002,1,1,1,3
12576,36,5,1315.83,3,4,3,10
12577,35,2,426.76,3,2,2,7
12578,21,2,2402.51,3,2,4,9
12579,78,1,386.41999999999996,2,1,2,5
12580,247,1,379.7,1,1,2,4
12581,40,1,179.70999999999998,3,1,1,5
12582,239,2,351.3599999999999,1,2,2,5
12583,3,14,5903.52,4,4,4,12
12584,4,9,2254.1499999999996,4,4,4,12
12585,234,1,669.25,1,1,3,5
12586,17,1,196.94000000000003,4,1,1,6
12587,8,1,104.0,4,1,1,6
12588,39,1,174.89999999999998,3,1,1,5
12589,29,2,574.6800000000001,3,2,2,7
12590,211,1,9341.26,1,1,4,6
12591,317,1,368.84999999999997,1,1,2,4
12592,92,2,401.6,2,2,2,6
12593,109,3,382.0999999999999,2,3,2,7
12594,38,9,3208.2200000000003,3,4,4,11
12596,51,2,450.27,2,2,2,6
12597,19,4,3195.2200000000003,3,3,4,10
12598,10,7,2807.0799999999995,4,4,4,12
12599,29,7,888.5800000000003,3,4,3,10
12600,29,8,2072.24,3,4,4,11
12601,190,5,487.05999999999995,1,4,2,7
12602,59,1,153.12,2,1,1,4
12603,22,1,613.1999999999999,3,1,2,6
12604,79,2,236.17999999999995,2,2,1,5
12607,60,1,1579.51,2,1,3,6
12609,78,3,964.85,2,3,3,8
12610,23,4,1747.5400000000004,3,3,4,10
12611,52,1,1193.32,2,1,3,6
12612,74,1,668.04,2,1,3,6
12613,57,4,3092.38,2,3,4,9
12614,278,1,315.59999999999997,1,1,2,4
12615,2,4,2093.1900000000005,4,3,4,11
12616,95,2,641.3,2,2,2,6
12617,29,1,352.97999999999996,3,1,2,6
12618,22,1,137.31,3,1,1,5
12619,16,8,2945.5599999999995,4,4,4,12
12620,15,3,1303.41,4,3,3,10
12621,2,18,11172.02,4,4,4,12
12622,232,1,162.09999999999997,1,1,1,3
12623,276,1,269.1,1,1,1,3
12624,106,2,569.13,2,2,2,6
12625,212,2,2413.8200000000006,1,2,4,7
12626,23,9,5954.4800000000005,3,4,4,11
12627,11,6,4082.5299999999997,4,4,4,12
12628,4,3,732.46,4,3,3,10
12630,10,2,1030.88,4,2,3,9
12631,57,1,480.50000000000006,2,1,2,5
12633,59,4,1929.98,2,3,4,9
12635,90,2,1509.1800000000003,2,2,3,7
12637,67,8,5804.9,2,4,4,10
12638,33,1,511.6900000000001,3,1,2,6
12639,239,1,366.1,1,1,2,4
12640,24,3,994.58,3,3,3,9
12641,115,1,145.9,2,1,1,4
12642,25,3,905.2599999999999,3,3,3,9
12643,128,6,3041.64,2,4,4,10
12644,130,1,477.90999999999997,1,1,2,4
12645,34,4,1631.1799999999998,3,3,4,10
12646,5,2,1346.97,4,2,3,9
12647,22,8,2151.22,3,4,4,11
12648,155,1,300.04999999999995,1,1,1,3
12649,107,3,569.51,2,3,2,7
12650,3,1,242.44,4,1,1,6
12651,335,1,114.0,1,1,1,3
12652,331,1,793.98,1,1,3,5
12653,149,2,2209.85,1,2,4,7
12654,11,5,529.98,4,4,2,10
12656,17,5,3619.17,4,4,4,12
12657,11,4,1427.18,4,3,3,10
12658,19,1,632.05,3,1,2,6
12659,30,1,73.68,3,1,1,5
12660,11,1,227.10000000000002,4,1,1,6
12662,1,10,3300.3,4,4,4,12
12664,8,9,4391.88,4,4,4,12
12665,325,1,45.0,1,1,1,3
12667,58,1,460.13,2,1,2,5
12668,12,3,2779.28,4,3,4,11
12669,151,2,1427.73,1,2,3,6
12670,10,5,2744.0499999999997,4,4,4,12
12672,330,1,225.9,1,1,1,3
12673,5,2,574.52,4,2,2,8
12674,39,4,1844.6,3,3,4,10
12676,25,6,1091.39,3,4,3,10
12678,42,8,16278.180000000002,3,4,4,11
12679,59,4,951.0200000000001,2,3,3,8
12680,1,4,790.8100000000001,4,3,3,10
12681,15,20,10409.43,4,4,4,12
12682,4,29,10070.529999999999,4,4,4,12
12683,4,12,6657.49,4,4,4,12
12684,8,6,2073.63,4,4,4,12
12685,28,6,2575.08,3,4,4,11
12688,114,1,4873.8099999999995,2,1,4,7
12689,26,2,1139.61,3,2,3,8
12690,206,1,335.00999999999993,1,1,2,4
12691,28,4,765.8,3,3,3,9
12693,127,4,711.91,2,3,3,8
12694,70,2,761.67,2,2,3,7
12695,7,4,582.1,4,3,2,9
12697,29,3,757.59,3,3,3,9
12700,8,4,4525.99,4,3,4,11
12701,80,2,725.71,2,2,3,7
12702,20,1,201.0,3,1,1,5
12703,71,1,265.55,2,1,1,4
12704,7,8,1740.8400000000001,4,4,4,12
12705,15,7,5686.290000000001,4,4,4,12
12707,292,1,603.42,1,1,2,4
12708,30,9,2264.4700000000003,3,4,4,11
12709,15,13,8210.830000000002,4,4,4,12
12710,97,3,1023.0200000000001,2,3,3,8
12712,29,11,3511.4999999999995,3,4,4,11
12713,1,1,794.5500000000002,4,1,3,8
12714,9,5,4294.860000000001,4,4,4,12
12715,106,1,263.35999999999996,2,1,1,4
12716,4,2,963.4900000000001,4,2,3,9
12717,151,2,830.9799999999999,1,2,3,6
12718,71,1,202.25,2,1,1,4
12719,5,2,572.95,4,2,2,8
12720,3,23,4584.6,4,4,4,12
12721,32,5,2117.5299999999997,3,4,4,11
12722,85,4,979.6300000000001,2,3,3,8
12723,4,5,707.07,4,4,3,11
12724,5,4,923.41,4,3,3,10
12726,28,6,2258.8199999999997,3,4,4,11
12727,11,7,3440.7000000000003,4,4,4,12
12728,71,4,728.3299999999999,2,3,3,8
12729,114,1,417.01000000000005,2,1,2,5
12731,24,11,17824.010000000002,3,4,4,11
12732,180,1,218.26000000000005,1,1,1,3
12733,234,1,383.95000000000005,1,1,2,4
12735,315,2,689.5699999999999,1,2,3,6
12736,333,1,144.0,1,1,1,3
12739,99,1,975.5400000000001,2,1,3,6
12740,64,1,427.59999999999997,2,1,2,5
12744,56,4,9120.39,2,3,4,9
12747,2,9,3489.74,4,4,4,12
12748,1,171,27508.010000000002,4,4,4,12
12749,4,5,4040.879999999999,4,4,4,12
12750,129,1,275.88,1,1,1,3
12752,81,1,4366.780000000001,2,1,4,7
12753,23,5,17838.800000000003,3,4,4,11
12754,236,3,3010.7400000000002,1,3,4,8
12755,281,1,17.549999999999997,1,1,1,3
12756,87,1,112.08000000000001,2,1,1,4
12757,16,9,4176.75,4,4,4,12
12758,117,2,2791.59,2,2,4,8
12759,52,3,1411.44,2,3,3,8
12762,8,2,1702.5200000000002,4,2,4,10
12763,138,1,174.0,1,1,1,3
12764,317,1,1693.88,1,1,4,6
12766,4,6,5476.34,4,4,4,12
12769,239,1,1143.6,1,1,3,5
12770,211,1,1351.4499999999998,1,1,3,5
12772,60,1,752.4700000000001,2,1,3,6
12775,17,5,1281.0400000000002,4,4,3,11
12778,20,6,693.23,3,4,3,10
12779,38,7,3733.2,3,4,4,11
12781,64,2,786.74,2,2,3,7
12782,5,4,1559.4200000000003,4,3,3,10
12783,2,4,1295.8700000000001,4,3,3,10
12784,15,1,476.82,4,1,2,7
12787,10,3,418.66,4,3,2,9
12789,65,1,76.85000000000001,2,1,1,4
12790,192,1,294.9200000000001,1,1,1,3
12792,257,1,344.53999999999996,1,1,2,4
12793,335,1,357.68,1,1,2,4
12794,53,2,860.41,2,2,3,7
12795,19,1,318.48,3,1,2,6
12798,10,3,6977.04,4,3,4,11
12802,187,1,397.58000000000004,1,1,2,4
12808,37,2,354.25000000000006,3,2,2,7
12809,178,1,405.31,1,1,2,4
12811,262,2,458.84999999999997,1,2,2,5
12812,45,1,229.64,3,1,1,5
12814,102,1,85.92,2,1,1,4
12815,148,2,863.4599999999999,1,2,3,6
12816,96,2,452.2,2,2,2,6
12817,281,1,126.03999999999999,1,1,1,3
12818,262,1,1182.08,1,1,3,5
12820,3,4,942.34,4,3,3,10
12821,214,1,92.72,1,1,1,3
12822,71,2,948.8800000000002,2,2,3,7
12823,75,5,1759.5,2,4,4,10
12824,60,1,397.11999999999995,2,1,2,5
12826,3,6,1319.72,4,4,3,11
12827,6,3,430.15,4,3,2,9
12828,3,6,1018.71,4,4,3,11
12829,337,1,207.25,1,1,1,3
12830,38,6,6814.640000000001,3,4,4,11
12831,262,1,215.05,1,1,1,3
12832,32,2,383.03000000000003,3,2,2,7
12833,145,1,417.38,1,1,2,4
12834,283,1,312.38,1,1,2,4
12836,59,4,2610.3599999999997,2,3,4,9
12837,173,1,134.1,1,1,1,3
12838,34,1,281.15999999999997,3,1,1,5
12839,3,12,4853.97,4,4,4,12
12840,144,4,2726.77,1,3,4,8
12841,5,23,3485.59,4,4,4,12
12842,70,2,1118.99,2,2,3,7
12843,66,8,1702.2600000000002,2,4,4,10
12844,29,2,325.96,3,2,2,7
12845,267,4,354.09,1,3,2,6
12847,22,1,843.6399999999999,3,1,3,7
12849,31,2,992.65,3,2,3,8
12851,97,1,131.80999999999997,2,1,1,4
12852,295,1,311.55,1,1,2,4
12853,135,6,1957.1000000000004,1,4,4,9
12854,79,3,1316.2500000000002,2,3,3,8
12856,8,6,2170.7799999999997,4,4,4,12
12857,211,2,1106.4,1,2,3,6
12863,52,1,521.2,2,1,2,5
12864,138,1,147.12,1,1,1,3
12865,26,2,1568.23,3,2,3,8
12866,283,1,499.12,1,1,2,4
12867,26,6,3646.55,3,4,4,11
12868,186,5,1403.76,1,4,3,8
12871,84,2,380.64000000000004,2,2,2,6
12872,327,1,221.43999999999997,1,1,1,3
12873,282,1,374.0,1,1,2,4
12875,143,1,49.470000000000006,1,1,1,3
12876,58,2,2053.02,2,2,4,8
12877,4,11,1385.71,4,4,3,11
12878,236,2,854.99,1,2,3,6
12879,45,3,573.22,3,3,2,8
12881,276,1,298.0,1,1,1,3
12882,9,2,1463.0399999999997,4,2,3,9
12883,25,4,703.47,3,3,3,9
12884,88,1,309.05000000000007,2,1,2,5
12885,63,3,1175.2199999999998,2,3,3,8
12886,68,2,1378.3999999999999,2,2,3,7
12888,214,2,354.12,1,2,2,5
12890,24,1,376.71999999999997,3,1,2,6
12891,186,3,331.0,1,3,2,6
12893,31,1,176.54999999999998,3,1,1,5
12895,42,2,372.8,3,2,2,7
12897,205,2,216.5,1,2,1,4
12901,9,28,17654.539999999997,4,4,4,12
12902,265,1,138.67999999999998,1,1,1,3
12904,18,2,496.06,3,2,2,7
12906,12,5,2919.81,4,4,4,12
12908,176,2,750.0,1,2,3,6
12909,40,5,2178.67,3,4,4,11
12910,23,8,3075.0400000000004,3,4,4,11
12912,3,5,1662.3,4,4,4,12
12913,5,4,2066.0099999999998,4,3,4,11
12915,149,1,164.0,1,1,1,3
12916,139,4,2944.95,1,3,4,8
12917,128,1,594.0,2,1,2,5
12919,8,6,1335.19,4,4,3,11
12920,17,1,162.77999999999997,4,1,1,6
12921,9,35,15899.289999999999,4,4,4,12
12922,161,1,405.38,1,1,2,4
12923,64,1,171.57,2,1,1,4
12924,88,4,925.7500000000001,2,3,3,8
12925,5,2,694.05,4,2,3,9
12928,35,4,1670.36,3,3,4,10
12929,312,1,117.85,1,1,1,3
12930,78,2,415.8,2,2,2,6
12931,22,13,41878.96,3,4,4,11
12933,24,3,607.53,3,3,2,8
12935,2,7,2160.7,4,4,4,12
12936,17,4,1063.8999999999999,4,3,3,10
12937,15,4,1504.2700000000002,4,3,3,10
12938,26,1,114.13999999999999,3,1,1,5
12939,64,8,11581.800000000001,2,4,4,10
12940,55,2,899.69,2,2,3,7
12942,131,2,416.8499999999999,1,2,2,5
12944,36,1,317.56,3,1,2,6
12945,288,1,462.95000000000005,1,1,2,4
12947,144,5,1299.95,1,4,3,8
12948,16,7,2064.95,4,4,4,12
12949,31,8,4167.22,3,4,4,11
12950,2,3,1843.0,4,3,4,11
12951,9,6,1064.07,4,4,3,11
12952,6,4,1387.79,4,3,3,10
12953,10,1,329.85,4,1,2,7
12955,1,11,4757.160000000001,4,4,4,12
12956,306,1,108.07,1,1,1,3
12957,10,8,4017.54,4,4,4,12
12962,7,2,266.39,4,2,1,7
12963,8,7,1490.8300000000002,4,4,3,11
12965,89,1,769.8100000000001,2,1,3,6
12966,10,1,160.18,4,1,1,6
12968,112,1,135.95,2,1,1,4
12970,7,4,405.47,4,3,2,9
12971,4,81,10753.720000000001,4,4,4,12
12974,198,1,144.8,1,1,1,3
12976,212,1,738.6,1,1,3,5
12977,156,1,39.24,1,1,1,3
12980,158,8,6485.580000000001,1,4,4,9
12981,30,2,372.2199999999999,3,2,2,7
12982,243,1,390.53999999999996,1,1,2,4
12984,19,1,97.5,3,1,1,5
12985,1,2,1239.3799999999999,4,2,3,9
12987,74,2,558.7,2,2,2,6
12988,292,1,505.82000000000005,1,1,2,4
12989,3,14,6721.61,4,4,4,12
12990,31,3,409.5000000000001,3,3,2,8
12991,23,2,503.76000000000005,3,2,2,7
12993,23,4,414.75999999999993,3,3,2,8
12994,4,3,974.42,4,3,3,10
12995,85,1,211.32,2,1,1,4
12997,22,4,1226.89,3,3,3,9
12999,196,3,455.88,1,3,2,6
13000,107,2,333.09999999999997,2,2,2,6
13001,4,13,9785.970000000001,4,4,4,12
13002,318,1,120.94999999999999,1,1,1,3
13003,106,3,149.05,2,3,1,6
13004,12,17,5298.9,4,4,4,12
13005,174,2,513.6999999999999,1,2,2,5
13006,56,1,81.57,2,1,1,4
13008,323,1,229.47000000000003,1,1,1,3
13012,9,8,1646.84,4,4,4,12
13013,1,11,3282.6000000000004,4,4,4,12
13014,11,10,3466.2799999999997,4,4,4,12
13015,53,5,3339.6400000000003,2,4,4,10
13016,73,3,789.8899999999999,2,3,3,8
13017,7,1,204.0,4,1,1,6
13018,16,28,7277.700000000001,4,4,4,12
13021,4,8,2459.0299999999997,4,4,4,12
13023,64,2,599.9,2,2,2,6
13026,1,5,975.36,4,4,3,11
13027,114,5,5472.0,2,4,4,10
13028,23,2,661.3200000000002,3,2,3,8
13029,31,2,865.0,3,2,3,8
13030,11,1,350.0799999999999,4,1,2,7
13032,52,2,1010.1800000000002,2,2,3,7
13034,55,1,476.9099999999999,2,1,2,5
13035,74,2,921.88,2,2,3,7
13037,138,3,881.07,1,3,3,7
13038,80,3,908.46,2,3,3,8
13040,9,2,676.99,4,2,3,9
13043,273,1,516.4200000000001,1,1,2,4
13044,291,1,560.47,1,1,2,4
13045,99,1,305.28,2,1,2,5
13046,31,2,629.31,3,2,2,7
13047,57,6,2865.96,2,4,4,10
13048,14,4,1819.4099999999999,4,3,4,11
13049,64,2,656.6800000000002,2,2,3,7
13050,15,13,4633.24,4,4,4,12
13052,212,1,348.15000000000003,1,1,2,4
13055,78,3,1214.41,2,3,3,8
13058,25,3,271.4,3,3,1,7
13059,250,1,183.4,1,1,1,3
13060,254,1,307.53000000000003,1,1,2,4
13061,72,1,248.61,2,1,1,4
13062,191,1,346.98,1,1,2,4
13064,13,4,1105.5900000000001,4,3,3,10
13066,24,2,470.79999999999995,3,2,2,7
13067,82,1,115.46000000000001,2,1,1,4
13068,10,2,344.0,4,2,2,8
13069,1,20,3787.3199999999997,4,4,4,12
13070,192,1,228.8,1,1,1,3
13072,267,1,177.14999999999998,1,1,1,3
13075,130,1,919.6100000000001,1,1,3,5
13077,1,3,414.3,4,3,2,9
13078,3,24,11746.779999999999,4,4,4,12
13079,4,5,220.09999999999997,4,4,1,9
13080,179,1,58.08,1,1,1,3
13081,12,9,25970.6,4,4,4,12
13082,126,9,3613.6299999999997,2,4,4,10
13083,4,2,303.75,4,2,2,8
13085,158,2,416.08000000000004,1,2,2,5
13089,3,89,52808.87,4,4,4,12
13090,9,11,7902.42,4,4,4,12
13091,28,1,345.82000000000005,3,1,2,6
13092,71,4,292.38,2,3,1,6
13093,276,5,4036.9600000000005,1,4,4,9
13094,21,11,1703.64,3,4,4,11
13095,71,1,74.4,2,1,1,4
13097,33,9,5698.32,3,4,4,11
13098,1,28,28882.44,4,4,4,12
13099,99,1,207.35999999999999,2,1,1,4
13101,234,1,101.19,1,1,1,3
13102,1,22,5750.17,4,4,4,12
13103,40,1,243.94,3,1,1,5
13104,3,5,996.72,4,4,3,11
13106,133,1,76.5,1,1,1,3
13107,44,4,1531.6200000000003,3,3,3,9
13109,60,2,786.54,2,2,3,7
13110,31,7,1488.67,3,4,3,10
13113,1,23,11872.989999999998,4,4,4,12
13115,12,4,2294.7799999999997,4,3,4,11
13116,138,1,501.14,1,1,2,4
13117,22,6,596.7600000000001,3,4,2,9
13118,20,5,1197.81,3,4,3,10
13120,239,1,30.599999999999998,1,1,1,3
13121,269,1,283.72999999999996,1,1,1,3
13122,94,2,922.39,2,2,3,7
13124,90,2,2500.01,2,2,4,8
13126,5,6,1876.2000000000003,4,4,4,12
13127,78,1,259.16999999999996,2,1,1,4
13130,94,1,64.0,2,1,1,4
13131,23,3,1073.2999999999997,3,3,3,9
13132,262,1,77.3,1,1,1,3
13133,274,2,109.80000000000001,1,2,1,4
13134,86,4,1793.5800000000002,2,3,4,9
13135,197,1,3096.0,1,1,4,6
13136,56,5,2607.6099999999997,2,4,4,10
13137,11,8,3603.29,4,4,4,12
13138,22,5,769.1600000000001,3,4,3,10
13139,16,7,5064.9400000000005,4,4,4,12
13140,108,2,264.21,2,2,1,5
13141,85,5,2388.75,2,4,4,10
13142,19,1,307.0899999999999,3,1,2,6
13144,333,1,110.94999999999999,1,1,1,3
13145,40,3,323.52,3,3,2,8
13146,26,1,228.91,3,1,1,5
13147,10,4,712.8000000000001,4,3,3,10
13148,29,11,3373.86,3,4,4,11
13149,14,4,1676.0600000000002,4,3,4,11
13151,296,1,1257.8700000000003,1,1,3,5
13153,6,1,486.22,4,1,2,7
13155,33,3,592.0600000000001,3,3,2,8
13157,49,4,1741.2199999999998,2,3,4,9
13158,95,4,1201.06,2,3,3,8
13159,9,4,1429.3500000000001,4,3,3,10
13160,22,1,91.8,3,1,1,5
13161,313,1,112.75,1,1,1,3
13162,122,4,1688.2899999999997,2,3,4,9
13165,46,1,666.8399999999998,3,1,3,7
13166,283,1,417.20000000000005,1,1,2,4
13167,19,4,779.3299999999999,3,3,3,9
13168,36,4,1299.5900000000001,3,3,3,9
13169,64,2,712.88,2,2,3,7
13170,27,1,108.81,3,1,1,5
13171,22,3,468.40999999999997,3,3,2,8
13173,4,1,187.70999999999998,4,1,1,6
13174,16,2,1369.76,4,2,3,9
13176,46,1,481.49000000000007,3,1,2,6
13177,65,1,282.45,2,1,1,4
13178,26,10,5015.469999999999,3,4,4,11
13182,45,1,121.18,3,1,1,5
13183,8,9,3957.7800000000007,4,4,4,12
13184,15,10,1667.95,4,4,4,12
13185,268,1,71.4,1,1,1,3
13186,40,3,1575.89,3,3,3,9
13187,337,1,236.01999999999998,1,1,1,3
13188,11,1,114.60000000000001,4,1,1,6
13189,19,2,260.67999999999995,3,2,1,6
13192,95,2,911.9400000000002,2,2,3,7
13193,61,1,112.08,2,1,1,4
13194,136,1,60.7,1,1,1,3
13196,11,4,1797.78,4,3,4,11
13198,10,5,3016.6899999999996,4,4,4,12
13199,4,35,9090.32,4,4,4,12
13200,19,4,870.0900000000001,3,3,3,9
13203,10,4,869.4599999999999,4,3,3,10
13207,15,2,250.26000000000002,4,2,1,7
13208,59,5,1193.17,2,4,3,9
13209,30,7,5572.76,3,4,4,11
13210,94,1,353.48,2,1,2,5
13211,10,2,984.72,4,2,3,9
13212,20,3,786.83,3,3,3,9
13213,57,5,1520.58,2,4,3,9
13216,268,1,333.74,1,1,2,4
13217,122,3,533.98,2,3,2,7
13218,127,1,62.64,2,1,1,4
13220,78,4,819.29,2,3,3,8
13221,240,1,346.70000000000005,1,1,2,4
13223,200,2,163.20000000000002,1,2,1,4
13224,60,2,2152.95,2,2,4,8
13225,3,6,5257.120000000001,4,4,4,12
13226,273,1,108.21,1,1,1,3
13227,202,1,257.7,1,1,1,3
13228,81,1,358.0,2,1,2,5
13229,226,1,160.95,1,1,1,3
13230,4,13,2662.18,4,4,4,12
13232,13,7,1327.75,4,4,3,11
13233,74,2,605.1199999999999,2,2,2,6
13235,212,1,1031.0700000000002,1,1,3,5
13236,25,2,744.85,3,2,3,8
13238,17,3,609.58,4,3,2,9
13239,262,1,329.56,1,1,2,4
13240,96,3,424.63000000000005,2,3,2,7
13242,112,3,270.40000000000003,2,3,1,6
13243,203,1,585.12,1,1,2,4
13244,93,1,121.74,2,1,1,4
13245,51,1,430.5,2,1,2,5
13246,18,6,1961.52,3,4,4,11
13247,18,4,501.11999999999995,3,3,2,8
13248,125,2,465.67999999999995,2,2,2,6
13249,92,3,711.41,2,3,3,8
13253,157,2,1030.3999999999999,1,2,3,6
13255,9,1,173.81,4,1,1,6
13258,12,3,672.83,4,3,3,10
13259,62,1,283.18,2,1,1,4
13260,61,1,557.62,2,1,2,5
13261,269,2,944.1,1,2,3,6
13262,263,1,200.29,1,1,1,3
13263,1,35,7426.709999999999,4,4,4,12
13265,53,5,2092.6600000000003,2,4,4,10
13266,11,12,3834.26,4,4,4,12
13267,3,17,3899.1900000000005,4,4,4,12
13268,18,10,3152.71,3,4,4,11
13269,1,13,4681.110000000001,4,4,4,12
13271,37,1,211.48999999999992,3,1,1,5
13272,31,2,276.56000000000006,3,2,1,6
13273,113,1,138.98,2,1,1,4
13276,64,2,590.93,2,2,2,6
13277,16,4,258.4,4,3,1,8
13278,41,1,542.73,3,1,2,6
13279,78,1,137.75,2,1,1,4
13280,122,3,798.46,2,3,3,8
13282,18,3,1132.14,3,3,3,9
13283,60,2,93.66,2,2,1,5
13284,331,1,201.19,1,1,1,3
13285,23,4,2709.1200000000003,3,3,4,10
13291,156,1,361.11,1,1,2,4
13292,39,2,578.9399999999999,3,2,2,7
13294,190,2,873.74,1,2,3,6
13296,137,1,87.4,1,1,1,3
13297,8,4,2089.85,4,3,4,11
13298,1,1,360.0,4,1,2,7
13299,268,1,142.5,1,1,1,3
13300,169,1,371.89,1,1,2,4
13301,104,4,600.19,2,3,2,7
13302,155,1,63.75,1,1,1,3
13305,4,9,1864.6599999999999,4,4,4,12
13307,120,1,15.0,2,1,1,4
13308,23,3,1385.51,3,3,3,9
13309,7,5,1456.79,4,4,3,11
13310,28,3,1132.0300000000002,3,3,3,9
13311,4,2,598.57,4,2,2,8
13313,22,5,1555.32,3,4,3,10
13314,2,3,775.94,4,3,3,10
13316,37,4,5732.93,3,3,4,10
13317,66,4,2035.6299999999999,2,3,4,9
13318,1,3,640.7600000000001,4,3,2,9
13319,5,22,9294.470000000001,4,4,4,12
13320,78,4,1532.1999999999998,2,3,3,8
13321,72,2,567.36,2,2,2,6
13322,17,1,199.48,4,1,1,6
13323,3,5,787.8499999999999,4,4,3,11
13324,36,9,6471.8499999999985,3,4,4,11
13325,82,1,675.3,2,1,3,6
13327,39,6,2882.77,3,4,4,11
13328,316,1,1308.48,1,1,3,5
13329,32,1,484.8,3,1,2,6
13330,93,3,1140.93,2,3,3,8
13332,14,1,350.9,4,1,2,7
13334,82,3,3502.32,2,3,4,9
13336,77,1,795.1200000000001,2,1,3,6
13338,158,1,437.02000000000004,1,1,2,4
13339,201,1,860.12,1,1,3,5
13340,45,7,10736.48,3,4,4,11
13341,261,1,775.8499999999999,1,1,3,5
13343,178,1,303.43,1,1,2,4
13344,68,3,2511.6900000000005,2,3,4,9
13345,288,1,339.5,1,1,2,4
13347,70,1,291.36,2,1,1,4
13348,64,1,233.76,2,1,1,4
13349,11,1,197.31999999999996,4,1,1,6
13350,16,2,879.12,4,2,3,9
13351,66,1,323.94,2,1,2,5
13352,60,1,347.98,2,1,2,5
13354,71,1,743.5300000000001,2,1,3,6
13355,122,1,674.7,2,1,3,6
13356,80,1,768.2400000000001,2,1,3,6
13357,257,1,609.4000000000001,1,1,2,4
13358,269,1,389.03000000000003,1,1,2,4
13359,64,1,389.55999999999995,2,1,2,5
13362,9,4,3090.7400000000002,4,3,4,11
13363,18,2,892.5,3,2,3,8
13364,71,1,134.96,2,1,1,4
13365,34,2,2225.37,3,2,4,9
13366,50,1,56.160000000000004,2,1,1,4
13368,257,2,573.4,1,2,2,5
13372,90,1,328.63999999999993,2,1,2,5
13373,61,3,3312.2500000000005,2,3,4,9
13375,89,1,778.65,2,1,3,6
13376,99,3,869.76,2,3,3,8
13379,26,3,572.56,3,3,2,8
13381,32,6,3639.31,3,4,4,11
13382,281,1,222.99,1,1,1,3
13384,31,7,4151.93,3,4,4,11
13385,330,1,534.5699999999999,1,1,2,4
13388,131,2,677.1,1,2,3,6
13389,11,3,797.9599999999999,4,3,3,10
13390,75,1,544.08,2,1,2,5
13391,204,1,59.8,1,1,1,3
13394,2,8,2520.0200000000004,4,4,4,12
13395,185,1,307.71999999999997,1,1,2,4
13396,29,2,1360.99,3,2,3,8
13397,73,5,1544.1299999999999,2,4,3,9
13398,192,1,457.34000000000003,1,1,2,4
13402,127,1,312.95,2,1,2,5
13403,18,1,75.0,3,1,1,5
13404,1,2,252.49,4,2,1,7
13405,74,3,572.4509999999999,2,3,2,7
13408,2,57,25085.839999999997,4,4,4,12
13410,24,5,1003.0600000000002,3,4,3,10
13411,107,1,213.55,2,1,1,4
13414,134,3,1390.5,1,3,3,7
13416,44,2,712.5,3,2,3,8
13417,5,2,640.83,4,2,2,8
13418,12,13,4547.81,4,4,4,12
13419,64,1,221.06,2,1,1,4
13420,150,2,159.85,1,2,1,4
13421,40,2,1823.2099999999998,3,2,4,9
13422,64,1,2626.3,2,1,4,7
13425,108,3,1624.2100000000003,2,3,4,9
13426,1,9,3304.34,4,4,4,12
13427,19,3,582.6,3,3,2,8
13428,10,1,201.78,4,1,1,6
13429,11,4,1006.7999999999998,4,3,3,10
13430,19,2,679.4499999999999,3,2,3,8
13431,67,2,1269.1,2,2,3,7
13434,74,2,534.24,2,2,2,6
13435,5,7,3809.89,4,4,4,12
13436,2,1,196.88999999999996,4,1,1,6
13437,14,7,3408.0600000000004,4,4,4,12
13439,255,1,283.71,1,1,1,3
13441,92,1,296.64000000000004,2,1,1,4
13447,23,3,1129.1400000000003,3,3,3,9
13448,17,3,2705.15,4,3,4,11
13449,24,1,291.88000000000005,3,1,1,5
13450,27,6,2043.72,3,4,4,11
13451,26,5,2898.2599999999998,3,4,4,11
13452,259,2,590.0,1,2,2,5
13453,166,2,356.97999999999996,1,2,2,5
13455,25,1,365.4,3,1,2,6
13456,18,6,1766.72,3,4,4,11
13458,7,13,8460.71,4,4,4,12
13460,29,2,183.44,3,2,1,6
13461,39,3,1445.0000000000002,3,3,3,9
13462,253,1,151.5,1,1,1,3
13464,58,1,674.6800000000001,2,1,3,6
13466,184,1,307.90000000000003,1,1,2,4
13467,11,2,1071.91,4,2,3,9
13468,2,33,4793.97,4,4,4,12
13470,99,2,165.0,2,2,1,5
13471,1,4,2501.84,4,3,4,11
13473,61,2,422.64000000000004,2,2,2,6
13474,236,1,226.83999999999995,1,1,1,3
13475,191,4,1431.7800000000002,1,3,3,7
13476,179,2,1238.47,1,2,3,6
13477,38,6,1454.5800000000002,3,4,3,10
13479,201,2,300.95,1,2,1,4
13481,46,5,1804.5600000000002,3,4,4,11
13482,232,1,184.64,1,1,1,3
13483,66,1,140.34,2,1,1,4
13484,241,1,313.8,1,1,2,4
13485,233,1,454.24,1,1,2,4
13486,78,3,1122.4099999999999,2,3,3,8
13487,58,2,382.25,2,2,2,6
13488,17,12,7586.389999999999,4,4,4,12
13489,105,4,449.52,2,3,2,7
13491,52,8,1019.4200000000001,2,4,3,9
13492,136,3,1269.84,1,3,3,7
13493,275,2,498.63,1,2,2,5
13494,312,1,316.26000000000005,1,1,2,4
13495,8,3,1179.4399999999998,4,3,3,10
13496,11,1,152.32,4,1,1,6
13497,283,1,194.55,1,1,1,3
13499,18,5,1159.11,3,4,3,10
13500,23,3,1166.77,3,3,3,9
13501,288,1,1340.32,1,1,3,5
13502,17,3,291.99999999999994,4,3,1,8
13503,71,1,216.85000000000002,2,1,1,4
13504,64,1,295.93000000000006,2,1,1,4
13505,73,4,3633.63,2,3,4,9
13506,316,1,157.4,1,1,1,3
13507,3,4,2479.16,4,3,4,11
13508,244,1,110.97000000000003,1,1,1,3
13509,9,6,964.72,4,4,3,11
13510,1,4,1791.56,4,3,4,11
13512,261,1,251.20999999999998,1,1,1,3
13513,127,1,205.09999999999997,2,1,1,4
13514,74,1,152.20000000000002,2,1,1,4
13515,73,4,891.12,2,3,3,8
13516,21,3,1389.4100000000003,3,3,3,9
13517,60,3,2128.42,2,3,4,9
13518,86,1,627.1600000000001,2,1,2,5
13519,78,1,122.75,2,1,1,4
13520,59,5,2760.95,2,4,4,10
13521,1,3,1070.47,4,3,3,10
13522,30,1,125.80000000000001,3,1,1,5
13523,33,4,3397.93,3,3,4,10
13524,41,5,680.1800000000001,3,4,3,10
13525,15,2,628.78,4,2,2,8
13527,34,7,2242.36,3,4,4,11
13529,79,2,307.76,2,2,2,6
13531,205,1,178.35,1,1,1,3
13532,34,1,210.30999999999995,3,1,1,5
13533,183,3,269.09000000000003,1,3,1,5
13534,2,23,5586.88,4,4,4,12
13536,1,7,3444.39,4,4,4,12
13538,43,7,1280.8500000000001,3,4,3,10
13539,86,3,631.34,2,3,2,7
13544,40,2,276.06,3,2,1,6
13546,12,3,621.09,4,3,2,9
13548,96,2,678.16,2,2,3,7
13549,26,7,918.1999999999999,3,4,3,10
13551,319,1,91.80000000000001,1,1,1,3
13552,66,12,3740.0699999999997,2,4,4,10
13555,74,4,4098.88,2,3,4,9
13557,28,2,584.06,3,2,2,7
13558,6,4,594.52,4,3,2,9
13560,7,1,171.42,4,1,1,6
13561,216,1,141.86,1,1,1,3
13562,82,3,1799.33,2,3,4,9
13563,84,2,777.53,2,2,3,7
13565,19,2,240.22,3,2,1,6
13566,41,2,856.8400000000001,3,2,3,8
13568,173,1,187.04999999999998,1,1,1,3
13569,17,1,227.3,4,1,1,6
13570,243,1,239.49000000000004,1,1,1,3
13571,13,12,2088.94,4,4,4,12
13572,206,1,1384.2499999999998,1,1,3,5
13573,50,2,290.25,2,2,1,5
13575,23,5,732.07,3,4,3,10
13576,10,17,6368.1900000000005,4,4,4,12
13577,25,4,1687.6000000000001,3,3,4,10
13579,15,1,302.34,4,1,2,7
13581,309,1,118.0,1,1,1,3
13583,156,1,781.03,1,1,3,5
13584,307,1,142.4,1,1,1,3
13587,64,1,712.4,2,1,3,6
13588,16,9,2478.95,4,4,4,12
13589,15,2,379.65000000000003,4,2,2,8
13590,11,6,1981.9199999999994,4,4,4,12
13591,65,3,1117.1299999999997,2,3,3,8
13592,36,4,247.95999999999998,3,3,1,7
13593,108,5,2011.8800000000006,2,4,4,10
13594,53,1,396.97,2,1,2,5
13596,6,2,664.11,4,2,3,9
13598,47,1,160.04000000000005,3,1,1,5
13599,1,19,4797.08,4,4,4,12
13600,312,1,219.51999999999998,1,1,1,3
13601,45,2,693.32,3,2,3,8
13602,65,1,428.89,2,1,2,5
13603,26,1,164.34,3,1,1,5
13606,29,3,276.75,3,3,1,7
13607,40,1,675.5100000000001,3,1,3,7
13610,12,7,1082.33,4,4,3,11
13611,89,2,851.2500000000001,2,2,3,7
13614,24,4,1585.46,3,3,4,10
13615,319,1,417.6900000000001,1,1,2,4
13617,40,3,544.1800000000001,3,3,2,8
13618,174,1,177.34,1,1,1,3
13621,117,1,213.85,2,1,1,4
13623,31,5,727.7399999999999,3,4,3,10
13626,253,1,257.22999999999996,1,1,1,3
13627,59,4,1327.28,2,3,3,8
13629,23,11,7792.360000000001,3,4,4,11
13630,5,7,2031.7800000000002,4,4,4,12
13631,100,11,3070.42,2,4,4,10
13632,25,5,2118.9300000000003,3,4,4,11
13634,33,5,1547.3599999999997,3,4,3,10
13635,68,1,1071.03,2,1,3,6
13636,37,5,949.12,3,4,3,10
13637,52,3,803.05,2,3,3,8
13638,16,1,122.64,4,1,1,6
13639,74,1,1033.3400000000001,2,1,3,6
13642,216,1,312.28000000000003,1,1,2,4
13643,31,3,519.44,3,3,2,8
13644,16,4,2624.26,4,3,4,11
13645,120,1,252.1,2,1,1,4
13647,10,4,1648.1200000000003,4,3,4,11
13649,257,1,148.8,1,1,1,3
13650,17,6,1836.3400000000001,4,4,4,12
13651,35,2,94.2,3,2,1,6
13652,46,2,786.2799999999999,3,2,3,8
13654,43,6,2707.33,3,4,4,11
13655,114,2,932.97,2,2,3,7
13656,165,2,379.65000000000003,1,2,2,5
13657,11,2,382.14,4,2,2,8
13658,10,5,2639.1700000000005,4,4,4,12
13659,206,2,1563.0,1,2,3,6
13662,86,3,881.26,2,3,3,8
13663,179,1,189.46999999999997,1,1,1,3
13666,60,3,84.65,2,3,1,6
13667,149,1,299.04999999999995,1,1,1,3
13668,3,20,6132.17,4,4,4,12
13669,51,2,218.55,2,2,1,5
13670,75,1,349.7,2,1,2,5
13672,301,2,186.39,1,2,1,4
13673,19,2,387.44000000000005,3,2,2,7
13675,151,2,486.82000000000005,1,2,2,5
13678,152,1,232.6,1,1,1,3
13680,1,4,3719.12,4,3,4,11
13681,18,4,827.83,3,3,3,9
13682,187,1,59.5,1,1,1,3
13684,286,1,65.13000000000001,1,1,1,3
13685,3,7,3119.44,4,4,4,12
13686,183,1,72.0,1,1,1,3
13689,63,1,910.0,2,1,3,6
13690,59,1,172.25,2,1,1,4
13692,25,3,1488.32,3,3,3,9
13694,4,48,62142.58,4,4,4,12
13695,31,15,2504.13,3,4,4,11
13697,39,1,151.3,3,1,1,5
13699,155,1,308.58,1,1,2,4
13700,26,10,2248.63,3,4,4,11
13703,318,1,99.5,1,1,1,3
13704,5,9,2308.0600000000004,4,4,4,12
13705,8,2,393.72,4,2,2,8
13706,303,1,330.79,1,1,2,4
13707,267,2,806.41,1,2,3,6
13708,271,1,283.33000000000004,1,1,1,3
13709,4,13,6307.650000000001,4,4,4,12
13710,32,1,180.48,3,1,1,5
13711,219,2,252.06000000000003,1,2,1,4
13712,247,1,228.83999999999997,1,1,1,3
13715,281,2,582.7099999999999,1,2,2,5
13716,269,1,138.28,1,1,1,3
13717,32,6,1445.0100000000002,3,4,3,10
13718,246,2,306.55,1,2,2,5
13719,15,5,1041.68,4,4,3,11
13720,117,4,799.9,2,3,3,8
13721,36,1,524.1400000000001,3,1,2,6
13722,132,3,2375.41,1,3,4,8
13723,217,1,199.85000000000002,1,1,1,3
13725,50,8,1980.56,2,4,4,10
13726,39,2,1079.6599999999999,3,2,3,8
13727,29,2,333.48,3,2,2,7
13728,37,6,1016.1400000000001,3,4,3,10
13730,136,2,752.6,1,2,3,6
13731,219,2,610.59,1,2,2,5
13732,28,1,491.86000000000007,3,1,2,6
13735,25,4,2883.5399999999995,3,3,4,10
13736,5,2,729.8,4,2,3,9
13737,200,1,339.6,1,1,2,4
13739,18,1,216.9,3,1,1,5
13740,241,1,350.75,1,1,2,4
13741,72,3,668.4300000000001,2,3,3,8
13742,17,12,3107.8700000000003,4,4,4,12
13743,3,7,1341.6,4,4,3,11
13744,95,2,1080.52,2,2,3,7
13745,162,1,300.03999999999996,1,1,1,3
13748,96,4,744.25,2,3,3,8
13750,54,5,1647.26,2,4,4,10
13751,288,1,296.25,1,1,1,3
13752,124,6,1175.3799999999999,2,4,3,9
13753,288,1,741.26,1,1,3,5
13754,152,2,282.6,1,2,1,4
13755,4,9,2108.06,4,4,4,12
13756,2,11,4185.120000000001,4,4,4,12
13758,12,5,2471.7000000000003,4,4,4,12
13759,33,2,659.41,3,2,3,8
13760,54,2,286.78999999999996,2,2,1,5
13761,50,2,1070.65,2,2,3,7
13762,219,1,306.72,1,1,2,4
13763,63,1,1714.9599999999998,2,1,4,7
13764,71,3,1516.42,2,3,3,8
13767,2,31,14781.000000000002,4,4,4,12
13769,2,9,2474.209999999999,4,4,4,12
13771,64,4,2634.45,2,3,4,9
13772,34,3,1122.63,3,3,3,9
13774,82,1,345.0,2,1,2,5
13777,1,23,19015.380000000005,4,4,4,12
13778,103,1,178.7,2,1,1,4
13780,7,2,360.01000000000005,4,2,2,8
13781,251,1,127.84,1,1,1,3
13782,13,6,908.8599999999999,4,4,3,11
13784,10,11,2462.7899999999995,4,4,4,12
13787,76,1,202.64,2,1,1,4
13790,4,1,348.79999999999995,4,1,2,7
13791,128,2,1516.0,2,2,3,7
13792,66,2,195.54999999999995,2,2,1,5
13798,1,55,32983.19,4,4,4,12
13799,117,2,688.8600000000001,2,2,3,7
13800,310,1,558.32,1,1,2,4
13801,67,1,324.79999999999995,2,1,2,5
13802,139,3,4599.42,1,3,4,8
13803,255,1,277.07000000000005,1,1,1,3
13804,31,7,2588.39,3,4,4,11
13805,52,2,924.5999999999999,2,2,3,7
13806,64,1,256.38,2,1,1,4
13808,6,5,1747.6600000000003,4,4,4,12
13809,305,1,155.05,1,1,1,3
13810,29,2,827.51,3,2,3,8
13811,184,2,519.75,1,2,2,5
13812,42,3,485.0,3,3,2,8
13813,40,4,1168.8600000000001,3,3,3,9
13814,92,2,1579.1200000000001,2,2,3,7
13815,22,4,3667.36,3,3,4,10
13816,24,2,499.67,3,2,2,7
13817,29,1,218.28000000000006,3,1,1,5
13819,302,3,1140.35,1,3,3,7
13821,145,2,385.64,1,2,2,5
13822,6,2,632.0,4,2,2,8
13823,19,2,957.66,3,2,3,8
13824,33,5,1698.94,3,4,4,11
13826,176,1,189.5,1,1,1,3
13827,58,3,409.8,2,3,2,7
13828,22,1,209.49000000000004,3,1,1,5
13831,16,5,1790.4499999999998,4,4,4,12
13832,19,1,52.199999999999996,3,1,1,5
13833,159,1,383.8499999999999,1,1,2,4
13835,25,4,834.57,3,3,3,9
13837,212,2,266.59000000000003,1,2,1,4
13838,6,3,444.15999999999997,4,3,2,9
13841,253,1,85.0,1,1,1,3
13842,59,8,3075.05,2,4,4,10
13844,11,1,361.62,4,1,2,7
13845,65,1,312.98,2,1,2,5
13846,25,2,453.65999999999997,3,2,2,7
13848,92,2,935.0,2,2,3,7
13849,52,2,1537.95,2,2,3,7
13850,129,1,1595.4800000000002,1,1,4,6
13851,96,3,2651.4599999999996,2,3,4,9
13853,57,1,1090.1399999999999,2,1,3,6
13854,9,23,7500.080000000001,4,4,4,12
13856,169,3,388.5,1,3,2,6
13858,57,1,216.17000000000002,2,1,1,4
13859,326,1,201.16,1,1,1,3
13860,1,5,1245.9,4,4,3,11
13862,18,8,2209.36,3,4,4,11
13863,248,1,305.78,1,1,2,4
13865,58,4,501.56,2,3,2,7
13866,74,1,145.67,2,1,1,4
13867,31,3,1005.0899999999999,3,3,3,9
13868,7,2,3192.54,4,2,4,10
13869,123,3,2760.03,2,3,4,9
13870,2,8,2770.94,4,4,4,12
13871,23,13,6403.25,3,4,4,11
13873,120,3,389.59999999999997,2,3,2,7
13875,54,5,1786.79,2,4,4,10
13876,64,1,122.69999999999999,2,1,1,4
13877,86,1,117.24000000000001,2,1,1,4
13878,55,1,1271.5699999999997,2,1,3,6
13880,21,12,3121.9700000000003,3,4,4,11
13881,4,20,17159.52,4,4,4,12
13882,3,5,1191.13,4,4,3,11
13883,11,5,2674.48,4,4,4,12
13884,7,5,787.6000000000001,4,4,3,11
13885,189,2,506.8,1,2,2,5
13886,71,1,243.56,2,1,1,4
13887,204,1,349.54999999999995,1,1,2,4
13888,120,2,595.67,2,2,2,6
13889,93,1,416.9,2,1,2,5
13890,1,9,1693.4599999999998,4,4,4,12
13892,27,4,632.97,3,3,2,8
13893,298,1,821.1000000000001,1,1,3,5
13894,24,3,564.6200000000001,3,3,2,8
13895,28,4,2593.0699999999997,3,3,4,10
13897,50,1,311.15999999999997,2,1,2,5
13898,326,1,155.93,1,1,1,3
13899,16,2,388.52,4,2,2,8
13900,183,3,740.9499999999999,1,3,3,7
13901,72,5,2867.2,2,4,4,10
13904,37,2,332.64000000000004,3,2,2,7
13908,80,4,2319.5499999999997,2,3,4,9
13911,57,9,2580.91,2,4,4,10
13914,12,2,626.45,4,2,2,8
13917,50,2,272.03999999999996,2,2,1,5
13918,50,2,1212.8400000000004,2,2,3,7
13919,59,2,348.81000000000006,2,2,2,6
13923,54,1,351.13000000000005,2,1,2,5
13924,2,6,1838.85,4,4,4,12
13925,93,4,678.25,2,3,3,8
13926,23,1,223.85000000000002,3,1,1,5
13927,75,1,348.99000000000007,2,1,2,5
13928,11,4,464.57,4,3,2,9
13929,169,2,842.65,1,2,3,6
13930,58,2,337.34,2,2,2,6
13931,96,2,1237.53,2,2,3,7
13932,295,1,307.4,1,1,2,4
13933,109,2,608.7899999999998,2,2,2,6
13934,264,1,922.0999999999999,1,1,3,5
13936,180,1,376.5799999999999,1,1,2,4
13937,169,1,158.85,1,1,1,3
13938,35,1,71.66,3,1,1,5
13939,23,3,568.55,3,3,2,8
13940,17,4,839.14,4,3,3,10
13941,22,4,4017.84,3,3,4,10
13946,79,3,561.57,2,3,2,7
13947,65,1,90.6,2,1,1,4
13949,3,6,2427.3199999999997,4,4,4,12
13950,11,4,745.0600000000001,4,3,3,10
13951,176,3,674.4499999999998,1,3,3,7
13952,218,2,3251.071,1,2,4,7
13953,7,6,3015.68,4,4,4,12
13954,2,2,439.92,4,2,2,8
13955,154,2,322.96,1,2,2,5
13956,5,5,1019.2700000000001,4,4,3,11
13959,79,2,379.29999999999995,2,2,2,6
13960,21,2,230.22,3,2,1,6
13962,22,2,169.55,3,2,1,6
13963,308,3,513.24,1,3,2,6
13967,146,1,80.7,1,1,1,3
13969,7,17,8706.58,4,4,4,12
13971,19,8,2758.26,3,4,4,11
13972,71,2,190.25000000000003,2,2,1,5
13973,287,1,264.7,1,1,1,3
13974,49,1,413.59,2,1,2,5
13975,31,6,2461.24,3,4,4,11
13976,207,1,357.98,1,1,2,4
13978,15,2,196.79,4,2,1,7
13979,73,1,869.8699999999998,2,1,3,6
13980,60,1,200.14000000000001,2,1,1,4
13982,39,3,1443.21,3,3,3,9
13983,30,11,2274.0699999999997,3,4,4,11
13984,27,4,765.71,3,3,3,9
13985,4,15,7060.13,4,4,4,12
13986,17,1,320.46000000000004,4,1,2,7
13988,20,6,4147.96,3,4,4,11
13989,66,2,1266.08,2,2,3,7
13990,213,1,311.3,1,1,2,4
13991,12,6,851.88,4,4,3,11
13992,30,1,76.8,3,1,1,5
13993,43,9,3466.3600000000006,3,4,4,11
13994,4,6,2274.1400000000003,4,4,4,12
13995,15,5,1393.69,4,4,3,11
13999,10,11,3599.71,4,4,4,12
14000,211,1,635.6600000000001,1,1,2,4
14001,46,2,1741.84,3,2,4,9
14002,134,2,529.7299999999999,1,2,2,5
14004,43,7,4582.639999999999,3,4,4,11
14005,10,5,2874.72,4,4,4,12
14006,116,3,962.1899999999999,2,3,3,8
14009,198,2,695.6099999999999,1,2,3,6
14012,278,1,328.8,1,1,2,4
14013,110,3,473.02,2,3,2,7
14014,77,1,505.18,2,1,2,5
14015,53,1,917.34,2,1,3,6
14016,162,3,3587.47,1,3,4,8
14019,47,3,1421.61,3,3,3,9
14020,17,2,642.8000000000001,4,2,2,8
14021,155,3,631.9000000000001,1,3,2,6
14022,225,1,440.0,1,1,2,4
14023,7,2,584.0699999999999,4,2,2,8
14024,122,2,327.70000000000005,2,2,2,6
14027,61,1,104.82000000000002,2,1,1,4
14029,63,2,467.66,2,2,2,6
14030,18,6,1682.34,3,4,4,11
14031,7,16,14717.91,4,4,4,12
14032,2,9,2356.17,4,4,4,12
14034,22,3,648.8900000000001,3,3,2,8
14035,29,5,1428.0200000000002,3,4,3,10
14036,285,1,626.65,1,1,2,4
14037,176,1,35.400000000000006,1,1,1,3
14038,78,3,1560.3799999999994,2,3,3,8
14039,33,1,152.2,3,1,1,5
14040,41,12,3560.32,3,4,4,11
14041,266,1,141.41,1,1,1,3
14044,27,4,646.4200000000001,3,3,2,8
14045,109,3,1333.35,2,3,3,8
14046,284,1,151.59,1,1,1,3
14047,9,4,1021.6900000000002,4,3,3,10
14048,305,1,409.93,1,1,2,4
14049,17,4,5578.72,4,3,4,11
14050,32,2,746.3599999999999,3,2,3,8
14051,1,20,13782.23,4,4,4,12
14052,20,1,225.36,3,1,1,5
14053,124,2,260.25,2,2,1,5
14054,65,1,92.46,2,1,1,4
14055,106,1,725.6400000000001,2,1,3,6
14056,1,23,8152.710000000001,4,4,4,12
14057,24,15,5285.74,3,4,4,11
14059,267,1,183.6,1,1,1,3
14060,5,16,5266.38,4,4,4,12
14062,10,9,9020.730000000001,4,4,4,12
14064,29,5,1334.3399999999997,3,4,3,10
14066,267,1,152.55,1,1,1,3
14067,64,2,374.7,2,2,2,6
14068,320,1,265.85,1,1,1,3
14071,4,8,1422.75,4,4,3,11
14073,32,1,151.04,3,1,1,5
14075,5,3,942.26,4,3,3,10
14076,129,1,118.67,1,1,1,3
14077,41,5,499.4200000000001,3,4,2,9
14078,102,5,913.13,2,4,3,9
14079,125,1,375.0999999999999,2,1,2,5
14080,33,1,45.599999999999994,3,1,1,5
14081,302,1,498.1,1,1,2,4
14083,4,6,558.5400000000001,4,4,2,10
14085,2,15,3255.8,4,4,4,12
14087,3,1,191.47,4,1,1,6
14088,10,13,50491.81,4,4,4,12
14089,57,1,158.75,2,1,1,4
14090,325,1,76.32000000000001,1,1,1,3
14092,8,12,3475.1800000000003,4,4,4,12
14093,12,1,433.85999999999996,4,1,2,7
14096,4,17,53258.42999999999,4,4,4,12
14098,37,1,147.34999999999997,3,1,1,5
14099,16,10,2720.65,4,4,4,12
14100,138,1,191.95000000000002,1,1,1,3
14101,74,6,5976.790000000001,2,4,4,10
14102,5,5,1105.8799999999999,4,4,3,11
14104,155,2,216.20999999999998,1,2,1,4
14105,239,1,1266.23,1,1,3,5
14107,52,6,2339.9900000000002,2,4,4,10
14108,31,2,597.9100000000001,3,2,2,7
14109,73,1,144.2,2,1,1,4
14110,4,12,5683.1500000000015,4,4,4,12
14111,14,4,692.85,4,3,3,10
14112,23,7,2915.15,3,4,4,11
14113,4,3,1406.92,4,3,3,10
14114,274,2,386.53,1,2,2,5
14116,20,5,1382.7399999999998,3,4,3,10
14117,144,1,90.0,1,1,1,3
14121,4,4,2780.15,4,3,4,11
14124,84,1,419.58000000000004,2,1,2,5
14125,11,3,2720.63,4,3,4,11
14126,8,3,706.1300000000001,4,3,3,10
14127,123,3,709.7099999999999,2,3,3,8
14128,61,2,637.5000000000002,2,2,2,6
14129,2,5,1123.8600000000001,4,4,3,11
14130,319,1,480.9100000000001,1,1,2,4
14132,2,11,3586.0299999999997,4,4,4,12
14133,130,3,605.6399999999999,1,3,2,6
14135,2,11,3743.2599999999998,4,4,4,12
14138,2,2,965.8800000000002,4,2,3,9
14139,46,1,415.81999999999994,3,1,2,6
14140,4,2,935.05,4,2,3,9
14141,3,4,915.1300000000001,4,3,3,10
14143,134,1,115.8,1,1,1,3
14145,47,4,3742.2,3,3,4,10
14146,9,4,2949.5699999999997,4,3,4,11
14147,78,2,483.4,2,2,2,6
14148,234,1,157.2,1,1,1,3
14149,221,1,446.62000000000006,1,1,2,4
14150,36,1,352.46,3,1,2,6
14152,75,2,621.29,2,2,2,6
14154,239,2,1345.62,1,2,3,6
14155,266,1,118.75,1,1,1,3
14156,10,53,116237.88,4,4,4,12
14157,20,2,424.89000000000004,3,2,2,7
14158,40,1,507.65999999999997,3,1,2,6
14159,20,10,4438.0599999999995,3,4,4,11
14161,216,2,814.47,1,2,3,6
14162,174,2,289.36,1,2,1,4
14163,87,4,2445.9100000000003,2,3,4,9
14164,71,2,1631.7700000000004,2,2,4,8
14165,276,1,120.44,1,1,1,3
14167,39,4,562.59,3,3,2,8
14171,98,1,363.79,2,1,2,5
14173,11,4,450.8400000000001,4,3,2,9
14174,33,1,134.46,3,1,1,5
14175,60,3,3222.3,2,3,4,9
14176,297,3,417.35,1,3,2,6
14177,86,4,549.46,2,3,2,7
14178,9,7,1580.2600000000002,4,4,3,11
14179,41,2,701.5699999999999,3,2,3,8
14180,11,21,3852.2700000000004,4,4,4,12
14184,67,1,452.89,2,1,2,5
14185,331,1,197.65,1,1,1,3
14188,31,6,2054.36,3,4,4,11
14189,2,14,4342.84,4,4,4,12
14191,2,13,4684.76,4,4,4,12
14193,68,2,853.3900000000001,2,2,3,7
14194,5,21,11349.52,4,4,4,12
14195,202,2,1011.9999999999998,1,2,3,6
14196,107,1,335.52,2,1,2,5
14198,18,4,701.4,3,3,3,9
14199,218,1,185.39999999999998,1,1,1,3
14201,60,6,680.2,2,4,3,9
14204,2,1,150.60999999999996,4,1,1,6
14205,17,2,466.70000000000005,4,2,2,8
14206,239,1,328.15999999999997,1,1,2,4
14208,95,1,151.73999999999998,2,1,1,4
14209,11,6,2073.4300000000003,4,4,4,12
14210,106,5,1600.89,2,4,4,10
14211,53,9,2241.1000000000004,2,4,4,10
14212,90,1,1070.48,2,1,3,6
14214,31,5,1004.3800000000001,3,4,3,10
14215,12,5,1623.7200000000003,4,4,4,12
14216,3,4,1839.3000000000002,4,3,4,11
14217,2,16,1886.6799999999998,4,4,4,12
14218,43,1,169.48000000000002,3,1,1,5
14219,4,1,89.94,4,1,1,6
14220,247,1,319.4200000000001,1,1,2,4
14221,42,9,3432.8,3,4,4,11
14222,177,1,683.1700000000001,1,1,3,5
14223,92,3,991.1300000000001,2,3,3,8
14224,110,4,1009.73,2,3,3,8
14226,29,5,2214.7899999999995,3,4,4,11
14227,26,10,3350.96,3,4,4,11
14229,52,3,1547.2,2,3,3,8
14231,184,3,925.71,1,3,3,7
14232,43,5,2048.07,3,4,4,11
14233,49,4,1462.7200000000003,2,3,3,8
14234,22,4,754.1200000000001,3,3,3,9
14235,75,5,3144.86,2,4,4,10
14236,81,1,301.56000000000006,2,1,2,5
14238,326,1,146.85,1,1,1,3
14239,43,11,2380.8500000000004,3,4,4,11
14240,30,2,890.3400000000001,3,2,3,8
14241,184,1,213.70000000000005,1,1,1,3
14242,235,2,280.55,1,2,1,4
14243,9,8,2116.7700000000004,4,4,4,12
14245,220,2,1693.4499999999998,1,2,4,7
14246,111,3,1474.0600000000002,2,3,3,8
14247,278,1,136.76999999999998,1,1,1,3
14248,318,1,302.58,1,1,2,4
14250,7,3,1904.05,4,3,4,11
14251,2,5,2879.7,4,4,4,12
14256,260,1,445.20000000000005,1,1,2,4
14257,64,5,3099.7200000000003,2,4,4,10
14258,9,9,12669.98,4,4,4,12
14259,142,1,120.0,1,1,1,3
14261,51,2,1163.45,2,2,3,7
14262,8,8,2618.2299999999996,4,4,4,12
14264,155,2,333.97,1,2,2,5
14267,163,3,1516.24,1,3,3,7
14270,332,1,492.65,1,1,2,4
14271,226,1,112.32,1,1,1,3
14272,74,2,437.96000000000004,2,2,2,6
14273,51,4,559.97,2,3,2,7
14276,99,3,1119.7400000000002,2,3,3,8
14277,15,3,4152.0,4,3,4,11
14280,197,1,134.04,1,1,1,3
14282,3,14,3130.4400000000005,4,4,4,12
14284,31,2,595.25,3,2,2,7
14285,21,4,1910.0100000000002,3,3,4,10
14286,24,3,4628.75,3,3,4,10
14287,8,3,176.63,4,3,1,8
14288,213,1,426.6,1,1,2,4
14289,9,6,911.26,4,4,3,11
14290,11,4,1537.0900000000001,4,3,3,10
14291,2,11,3883.25,4,4,4,12
14292,8,9,4871.929999999999,4,4,4,12
14293,3,3,681.6400000000001,4,3,3,10
14295,40,1,166.2,3,1,1,5
14297,18,4,1305.3299999999997,3,3,3,9
14298,8,39,46837.84,4,4,4,12
14299,8,8,3536.38,4,4,4,12
14300,19,1,43.2,3,1,1,5
14301,117,1,640.1400000000001,2,1,2,5
14304,223,1,383.45000000000005,1,1,2,4
14305,71,3,1858.9600000000003,2,3,4,9
14306,51,2,2093.3199999999997,2,2,4,8
14307,89,5,2212.6099999999997,2,4,4,10
14309,8,8,2204.78,4,4,4,12
14311,243,1,310.26,1,1,2,4
14312,47,6,1611.59,3,4,4,11
14314,107,1,120.0,2,1,1,4
14315,45,6,2481.13,3,4,4,11
14317,65,1,508.58,2,1,2,5
14320,207,2,477.78999999999996,1,2,2,5
14321,11,5,1530.7500000000002,4,4,3,11
14323,115,2,605.0600000000001,2,2,2,6
14326,242,1,183.85000000000002,1,1,1,3
14327,163,1,311.65000000000003,1,1,2,4
14329,17,7,4975.24,4,4,4,12
14331,124,2,462.65999999999997,2,2,2,6
14332,23,3,840.21,3,3,3,9
14333,68,1,415.2,2,1,2,5
14334,17,7,2232.06,4,4,4,12
14335,16,2,454.85999999999996,4,2,2,8
14336,17,4,1614.91,4,3,4,11
14338,161,2,588.2199999999999,1,2,2,5
14339,243,1,309.52,1,1,2,4
14340,219,1,134.7,1,1,1,3
14341,45,8,2166.9799999999996,3,4,4,11
14342,21,4,668.5600000000002,3,3,3,9
14344,127,5,534.2800000000001,2,4,2,8
14345,39,1,108.97999999999999,3,1,1,5
14346,121,2,1021.58,2,2,3,7
14348,260,1,409.57,1,1,2,4
14349,10,1,133.5,4,1,1,6
14350,274,1,282.92999999999995,1,1,1,3
14351,165,1,51.0,1,1,1,3
14352,157,4,1078.9600000000003,1,3,3,7
14353,215,1,90.6,1,1,1,3
14354,6,2,163.62,4,2,1,7
14356,80,2,701.23,2,2,3,7
14357,43,1,225.12,3,1,1,5
14359,19,3,912.1800000000001,3,3,3,9
14360,32,4,2118.03,3,3,4,10
14362,22,1,151.50000000000003,3,1,1,5
14364,109,8,3717.35,2,4,4,10
14367,8,16,9227.82,4,4,4,12
14368,320,1,155.0,1,1,1,3
14371,295,1,100.5,1,1,1,3
14375,185,1,235.56,1,1,1,3
14377,191,2,617.05,1,2,2,5
14379,44,2,348.1,3,2,2,7
14381,52,1,202.68,2,1,1,4
14382,26,1,615.4899999999999,3,1,2,6
14383,38,3,1247.69,3,3,3,9
14385,9,3,202.10999999999999,4,3,1,8
14386,297,1,142.4,1,1,1,3
14387,33,3,1727.6000000000001,3,3,4,10
14388,10,7,2900.04,4,4,4,12
14389,65,2,1043.46,2,2,3,7
14390,10,8,4418.87,4,4,4,12
14393,218,1,67.94999999999999,1,1,1,3
14395,2,8,3171.23,4,4,4,12
14396,65,1,377.64000000000004,2,1,2,5
14397,3,19,2612.96,4,4,4,12
14400,149,1,574.6999999999999,1,1,2,4
14401,4,12,3804.1,4,4,4,12
14403,130,4,1475.8100000000002,1,3,3,7
14404,34,5,1320.0900000000001,3,4,3,10
14406,119,1,156.75,2,1,1,4
14407,107,5,2142.73,2,4,4,10
14408,11,7,2599.03,4,4,4,12
14409,71,4,1730.65,2,3,4,9
14410,92,9,1099.27,2,4,3,9
14411,311,1,1063.0,1,1,3,5
14412,43,2,770.0300000000001,3,2,3,8
14414,92,6,1279.7800000000002,2,4,3,9
14415,1,12,5002.889999999999,4,4,4,12
14416,22,2,490.2200000000001,3,2,2,7
14418,4,3,1937.25,4,3,4,11
14419,11,5,927.6899999999999,4,4,3,11
14420,99,1,387.52,2,1,2,5
14421,57,2,813.1100000000001,2,2,3,7
14422,1,6,4263.639999999999,4,4,4,12
14423,218,1,265.2,1,1,1,3
14424,18,1,322.08,3,1,2,6
14426,24,10,4481.67,3,4,4,11
14427,50,2,363.34000000000003,2,2,2,6
14428,7,5,1224.0600000000002,4,4,3,11
14431,303,1,470.36,1,1,2,4
14432,10,6,2248.5,4,4,4,12
14434,22,6,1372.8,3,4,3,10
14436,99,1,89.06,2,1,1,4
14438,306,1,131.9,1,1,1,3
14439,320,1,2661.24,1,1,4,6
14440,8,4,1700.98,4,3,4,11
14441,1,4,1712.8900000000003,4,3,4,11
14442,205,2,1589.82,1,2,4,7
14443,54,3,1116.7,2,3,3,8
14446,1,4,1005.55,4,3,3,10
14447,19,5,1163.2300000000002,3,4,3,10
14448,9,1,273.0,4,1,1,6
14449,19,3,675.56,3,3,3,9
14450,181,3,483.24999999999994,1,3,2,6
14451,60,2,643.9000000000001,2,2,2,6
14452,11,2,259.05,4,2,1,7
14453,190,1,119.93,1,1,1,3
14456,5,9,3014.3199999999997,4,4,4,12
14457,311,1,113.64,1,1,1,3
14459,155,1,1837.92,1,1,4,6
14460,110,3,434.34000000000003,2,3,2,7
14461,148,3,2102.6699999999996,1,3,4,8
14462,66,11,1975.57,2,4,4,10
14463,98,3,529.62,2,3,2,7
14465,247,3,1038.44,1,3,3,7
14466,29,6,1892.6499999999999,3,4,4,11
14467,18,4,596.2600000000001,3,3,2,8
14470,12,2,461.19000000000005,4,2,2,8
14472,104,7,1606.29,2,4,4,10
14473,74,2,234.34,2,2,1,5
14474,46,1,547.6600000000001,3,1,2,6
14475,72,3,925.8499999999999,2,3,3,8
14476,257,1,193.0,1,1,1,3
14477,20,4,1309.6000000000001,3,3,3,9
14479,254,1,141.85000000000002,1,1,1,3
14480,11,1,279.05,4,1,1,6
14481,165,2,636.51,1,2,2,5
14482,18,6,2022.81,3,4,4,11
14483,282,1,137.1,1,1,1,3
14484,50,1,321.92,2,1,2,5
14485,39,1,162.8,3,1,1,5
14487,27,5,1040.3799999999997,3,4,3,10
14488,68,1,1064.2800000000002,2,1,3,6
14489,207,1,463.38,1,1,2,4
14491,175,1,213.73000000000005,1,1,1,3
14493,7,5,2383.2400000000002,4,4,4,12
14494,26,1,139.56,3,1,1,5
14495,51,2,123.79999999999998,2,2,1,5
14496,312,1,234.46999999999997,1,1,1,3
14497,309,1,475.37,1,1,2,4
14498,43,4,1791.1,3,3,4,10
14499,26,3,808.44,3,3,3,9
14500,88,3,356.85,2,3,2,7
14501,184,2,251.21,1,2,1,4
14502,20,11,2426.79,3,4,4,11
14503,3,6,3543.26,4,4,4,12
14504,47,4,673.26,3,3,3,9
14505,17,7,4820.83,4,4,4,12
14506,17,4,1703.65,4,3,4,11
14507,24,6,1367.8799999999997,3,4,3,10
14508,22,2,268.05000000000007,3,2,1,6
14511,11,5,1314.8100000000002,4,4,3,11
14512,188,2,275.28,1,2,1,4
14513,101,3,455.59000000000003,2,3,2,7
14514,61,3,990.2,2,3,3,8
14515,18,6,2076.8900000000003,3,4,4,11
14517,33,2,330.45000000000005,3,2,2,7
14518,64,1,174.37,2,1,1,4
14520,2,2,270.6,4,2,1,7
14522,24,4,974.54,3,3,3,9
14523,108,1,241.09,2,1,1,4
14524,32,8,1568.38,3,4,3,10
14525,20,8,3753.6,3,4,4,11
14527,3,51,7580.64,4,4,4,12
14528,37,1,364.21999999999997,3,1,2,6
14529,60,3,578.6099999999999,2,3,2,7
14530,26,6,2862.11,3,4,4,11
14532,236,3,710.25,1,3,3,7
14533,25,6,1516.22,3,4,3,10
14534,3,18,4395.650000000001,4,4,4,12
14535,60,3,2854.84,2,3,4,9
14536,260,1,170.95,1,1,1,3
14537,58,1,355.56000000000006,2,1,2,5
14538,65,2,388.24999999999994,2,2,2,6
14539,16,2,537.48,4,2,2,8
14540,10,3,952.66,4,3,3,10
14541,59,8,1453.35,2,4,3,9
14542,186,1,103.25000000000001,1,1,1,3
14543,29,15,3305.6800000000003,3,4,4,11
14544,24,1,902.53,3,1,3,7
14546,5,5,2573.9300000000003,4,4,4,12
14547,4,8,3974.7500000000005,4,4,4,12
14548,151,2,652.8,1,2,2,5
14549,311,1,289.24,1,1,1,3
14550,11,2,757.3700000000001,4,2,3,9
14551,18,2,186.23000000000002,3,2,1,6
14552,152,1,164.22,1,1,1,3
14553,19,5,859.2700000000001,3,4,3,10
14554,10,4,2279.4900000000002,4,3,4,11
14555,57,2,312.54,2,2,2,6
14557,85,1,788.38,2,1,3,6
14560,7,21,1829.6000000000001,4,4,4,12
14561,76,3,1080.76,2,3,3,8
14562,4,18,5006.77,4,4,4,12
14565,96,3,1781.71,2,3,4,9
14566,111,1,1432.0,2,1,3,6
14567,57,2,1530.3600000000001,2,2,3,7
14569,1,1,227.38999999999996,4,1,1,6
14570,281,2,217.21,1,2,1,4
14572,3,7,2804.54,4,4,4,12
14573,180,8,1237.8200000000002,1,4,3,8
14577,13,3,512.81,4,3,2,9
14578,3,1,168.63,4,1,1,6
14581,17,1,138.6,4,1,1,6
14582,41,1,114.11,3,1,1,5
14583,6,5,986.9599999999999,4,4,3,11
14584,169,4,1033.0600000000002,1,3,3,7
14585,50,1,157.05,2,1,1,4
14586,277,1,237.36,1,1,1,3
14587,19,9,1580.29,3,4,3,10
14591,15,4,1320.21,4,3,3,10
14592,35,3,557.9399999999999,3,3,2,8
14593,22,3,617.15,3,3,2,8
14594,7,1,108.33,4,1,1,6
14595,20,6,1740.6000000000001,3,4,4,11
14597,11,2,866.2400000000001,4,2,3,9
14598,44,1,221.97,3,1,1,5
14600,306,1,393.33,1,1,2,4
14601,11,1,213.96000000000004,4,1,1,6
14603,275,1,660.0,1,1,3,5
14606,1,83,10707.390000000001,4,4,4,12
14607,16,12,15021.5,4,4,4,12
14608,4,3,1581.1499999999999,4,3,3,10
14609,72,4,601.5600000000001,2,3,2,7
14616,243,3,406.08000000000004,1,3,2,6
14618,9,3,553.44,4,3,2,9
14619,246,1,394.43999999999994,1,1,2,4
14620,206,2,412.78000000000003,1,2,2,5
14621,1,4,1482.66,4,3,3,10
14622,185,1,320.58,1,1,2,4
14623,32,5,882.02,3,4,3,10
14624,57,2,225.84999999999997,2,2,1,5
14625,196,1,314.1,1,1,2,4
14626,24,4,2791.27,3,3,4,10
14628,91,2,671.9599999999999,2,2,3,7
14629,4,2,955.2600000000001,4,2,3,9
14631,51,3,1006.98,2,3,3,8
14632,263,1,114.56,1,1,1,3
14633,266,1,344.9000000000001,1,1,2,4
14636,36,2,609.8500000000001,3,2,2,7
14638,51,1,443.6,2,1,2,5
14639,52,5,2307.95,2,4,4,10
14640,24,6,2107.38,3,4,4,11
14641,22,1,110.46,3,1,1,5
14642,59,1,96.12,2,1,1,4
14643,170,1,335.87,1,1,2,4
14644,68,2,830.76,2,2,3,7
14645,157,2,597.0899999999999,1,2,2,5
14646,2,70,270561.14,4,4,4,12
14647,201,1,236.04,1,1,1,3
14649,5,4,1402.59,4,3,3,10
14651,67,2,653.7499999999998,2,2,2,6
14652,77,1,114.18,2,1,1,4
14653,1,7,1916.6999999999998,4,4,4,12
14655,8,4,1932.23,4,3,4,11
14656,169,2,291.05,1,2,1,4
14657,18,4,848.22,3,3,3,9
14658,5,2,247.14999999999998,4,2,1,7
14659,9,9,2529.93,4,4,4,12
14660,87,2,285.73999999999995,2,2,1,5
14661,27,1,107.95,3,1,1,5
14662,29,4,741.3699999999999,3,3,3,9
14664,20,2,636.24,3,2,2,7
14665,61,5,1835.6999999999998,2,4,4,10
14666,24,1,179.95,3,1,1,5
14667,11,20,7198.75,4,4,4,12
14669,242,3,1259.2400000000002,1,3,3,7
14670,280,2,392.86,1,2,2,5
14672,235,2,765.55,1,2,3,6
14673,3,4,1362.91,4,3,3,10
14675,16,1,596.36,4,1,2,7
14676,31,6,2548.2400000000002,3,4,4,11
14680,25,14,25878.71,3,4,4,11
14681,71,3,498.95,2,3,2,7
14682,188,2,52.0,1,2,1,4
14684,26,4,1033.15,3,3,3,9
14687,107,1,628.3799999999999,2,1,2,5
14688,8,20,5134.120000000001,4,4,4,12
14689,209,1,112.80000000000001,1,1,1,3
14690,44,2,355.05000000000007,3,2,2,7
14691,31,5,2114.33,3,4,4,11
14692,137,4,591.5500000000001,1,3,2,6
14693,265,1,172.9,1,1,1,3
14696,4,6,1784.33,4,4,4,12
14697,218,2,188.60999999999996,1,2,1,4
14698,2,5,1217.27,4,4,3,11
14699,214,1,109.13000000000001,1,1,1,3
14700,32,3,2195.0999999999995,3,3,4,10
14701,11,9,2526.09,4,4,4,12
14702,1,16,2941.34,4,4,4,12
14703,15,1,318.16999999999996,4,1,2,7
14704,11,9,1491.62,4,4,3,11
14705,199,1,179.0,1,1,1,3
14708,3,2,707.31,4,2,3,9
14709,15,12,4606.9400000000005,4,4,4,12
14710,14,4,599.48,4,3,2,9
14711,10,11,2839.62,4,4,4,12
14712,29,3,917.07,3,3,3,9
14713,9,9,2236.35,4,4,4,12
14714,24,1,160.19,3,1,1,5
14715,25,4,867.3800000000001,3,3,3,9
14716,43,2,307.50999999999993,3,2,2,7
14719,2,5,1581.8400000000001,4,4,3,11
14720,6,3,663.8100000000002,4,3,3,10
14722,147,1,180.42,1,1,1,3
14723,10,3,666.71,4,3,3,10
14725,25,1,655.5800000000002,3,1,3,7
14727,274,1,268.58,1,1,1,3
14730,1,8,1897.5700000000002,4,4,4,12
14731,47,3,380.02000000000004,3,3,2,8
14732,8,8,2702.49,4,4,4,12
14733,16,9,5228.690000000001,4,4,4,12
14735,4,30,5798.490000000001,4,4,4,12
14737,4,2,730.55,4,2,3,9
14738,43,7,1314.45,3,4,3,10
14739,4,6,3188.3999999999996,4,4,4,12
14740,197,3,1448.2099999999998,1,3,3,7
14741,12,4,905.04,4,3,3,10
14744,16,6,874.98,4,4,3,11
14745,113,5,1220.2600000000002,2,4,3,9
14747,249,1,328.19999999999993,1,1,2,4
14748,29,3,945.3299999999999,3,3,3,9
14752,44,1,389.63999999999993,3,1,2,6
14753,87,1,563.1499999999999,2,1,2,5
14754,45,2,638.05,3,2,2,7
14755,10,11,5010.280000000001,4,4,4,12
14756,15,1,738.9599999999998,4,1,3,8
14757,75,1,420.50000000000006,2,1,2,5
14758,145,4,1484.06,1,3,3,7
14759,5,3,1625.97,4,3,4,11
14760,297,1,89.2,1,1,1,3
14761,59,2,255.89999999999998,2,2,1,5
14762,264,1,300.52,1,1,1,3
14764,47,1,278.3,3,1,1,5
14765,29,3,254.11,3,3,1,7
14766,8,5,2292.97,4,4,4,12
14768,17,2,192.60000000000002,4,2,1,7
14769,3,7,10068.32,4,4,4,12
14770,232,2,876.42,1,2,3,6
14772,112,1,139.26,2,1,1,4
14775,58,2,605.3399999999999,2,2,2,6
14776,51,11,2538.2999999999997,2,4,4,10
14778,127,2,730.8599999999999,2,2,3,7
14779,281,3,386.15,1,3,2,6
14780,55,2,447.68,2,2,2,6
14782,320,1,200.10000000000002,1,1,1,3
14784,26,2,289.99,3,2,1,6
14785,10,2,77.4,4,2,1,7
14788,7,2,679.4399999999998,4,2,3,9
14789,29,1,197.64000000000001,3,1,1,5
14790,17,4,745.0600000000001,4,3,3,10
14792,64,1,6.2,2,1,1,4
14793,21,1,228.99,3,1,1,5
14794,3,7,1319.91,4,4,3,11
14795,166,1,131.45,1,1,1,3
14796,1,15,6945.110000000001,4,4,4,12
14798,53,3,173.74,2,3,1,6
14799,51,1,157.70000000000002,2,1,1,4
14800,48,10,3111.94,2,4,4,10
14801,61,1,189.34,2,1,1,4
14803,162,3,845.55,1,3,3,7
14804,9,1,353.27,4,1,2,7
14805,15,4,546.4000000000001,4,3,2,9
14806,75,1,193.39,2,1,1,4
14808,40,8,2718.6,3,4,4,11
14810,41,10,1907.44,3,4,4,11
14815,37,2,778.5,3,2,3,8
14816,197,1,271.85,1,1,1,3
14817,200,2,1010.34,1,2,3,6
14818,74,3,657.8,2,3,3,8
14819,64,2,272.07,2,2,1,5
14820,21,4,507.28999999999996,3,3,2,8
14823,180,3,321.42999999999995,1,3,2,6
14824,10,4,1127.7100000000003,4,3,3,10
14825,4,10,1824.5800000000004,4,4,4,12
14828,197,3,2139.76,1,3,4,8
14829,29,2,312.22,3,2,2,7
14830,53,1,188.03,2,1,1,4
14834,18,6,1720.3,3,4,4,11
14836,10,3,102.44999999999999,4,3,1,8
14837,90,4,1649.5000000000002,2,3,4,9
14840,268,1,62.85,1,1,1,3
14841,53,5,2900.6,2,4,4,10
14842,44,4,2824.6899999999996,3,3,4,10
14844,64,4,3189.8100000000004,2,3,4,9
14847,149,1,309.4,1,1,2,4
14849,22,20,7363.650000000001,3,4,4,11
14850,312,1,325.75,1,1,2,4
14851,23,2,511.3499999999999,3,2,2,7
14852,58,6,2836.69,2,4,4,10
14853,24,2,475.79999999999995,3,2,2,7
14854,78,7,2740.03,2,4,4,10
14855,119,2,645.65,2,2,2,6
14856,36,3,1290.53,3,3,3,9
14857,60,2,1173.12,2,2,3,7
14859,13,4,1353.74,4,3,3,10
14860,19,1,170.32,3,1,1,5
14861,52,1,125.79000000000002,2,1,1,4
14862,26,2,841.2,3,2,3,8
14863,29,1,266.76,3,1,1,5
14865,7,1,15.0,4,1,1,6
14866,11,10,14249.720000000001,4,4,4,12
14867,186,3,710.28,1,3,3,7
14868,3,8,2953.59,4,4,4,12
14869,9,2,721.45,4,2,3,9
14870,262,1,327.24999999999994,1,1,2,4
14871,3,3,380.33,4,3,2,9
14873,210,1,519.6800000000001,1,1,2,4
14875,108,2,1465.3199999999997,2,2,3,7
14878,13,8,1154.0800000000002,4,4,3,11
14880,77,3,690.59,2,3,3,8
14881,20,1,255.4,3,1,1,5
14882,27,2,589.7,3,2,2,7
14883,19,6,761.5899999999999,3,4,3,10
14885,132,1,765.3199999999999,1,1,3,5
14886,253,1,364.79999999999995,1,1,2,4
14887,79,1,1862.0,2,1,4,7
14888,207,1,369.2,1,1,2,4
14889,336,1,135.9,1,1,1,3
14890,254,1,125.65,1,1,1,3
14891,148,2,554.38,1,2,2,5
14893,10,2,1237.8500000000001,4,2,3,9
14894,85,1,655.7499999999999,2,1,3,6
14895,8,20,11138.71,4,4,4,12
14896,205,1,211.54999999999998,1,1,1,3
14897,8,4,1366.38,4,3,3,10
14898,23,5,1170.81,3,4,3,10
14901,11,6,924.24,4,4,3,11
14902,26,1,332.66,3,1,2,6
14903,21,5,2795.33,3,4,4,11
14904,2,2,1025.44,4,2,3,9
14905,158,2,616.15,1,2,2,5
14907,3,4,2540.4099999999994,4,3,4,11
14908,74,1,277.79999999999995,2,1,1,4
14910,3,4,434.35,4,3,2,9
14911,1,185,128673.89,4,4,4,12
14912,17,2,867.85,4,2,3,9
14913,36,3,926.5600000000002,3,3,3,9
14915,91,2,307.48,2,2,2,6
14916,71,4,1268.98,2,3,3,8
14918,116,2,1610.1499999999996,2,2,4,8
14920,213,2,977.77,1,2,3,6
14921,30,2,1316.0700000000002,3,2,3,8
14923,51,1,749.1,2,1,3,6
14924,246,1,310.05,1,1,2,4
14929,32,1,223.88,3,1,1,5
14930,109,3,2362.9600000000005,2,3,4,9
14931,5,4,864.6800000000001,4,3,3,10
14934,82,2,1890.94,2,2,4,8
14935,297,1,1784.71,1,1,4,6
14936,34,8,8137.020000000001,3,4,4,11
14937,57,3,1621.88,2,3,4,9
14944,30,12,5900.25,3,4,4,11
14946,14,1,100.9,4,1,1,6
14947,72,2,290.82000000000005,2,2,1,5
14948,23,6,1101.97,3,4,3,10
14950,19,1,371.2,3,1,2,6
14951,79,1,311.69000000000005,2,1,2,5
14952,60,10,7413.329999999999,2,4,4,10
14953,25,1,285.67,3,1,1,5
14954,12,1,294.84999999999997,4,1,1,6
14957,253,1,58.49,1,1,1,3
14958,147,3,483.73,1,3,2,6
14959,64,4,695.4199999999998,2,3,3,8
14960,8,2,221.26999999999998,4,2,1,7
14961,11,7,5861.98,4,4,4,12
14962,271,1,126.70000000000002,1,1,1,3
14963,10,5,1472.34,4,4,3,11
14964,247,1,206.21,1,1,1,3
14965,96,2,596.09,2,2,2,6
14966,15,1,183.01999999999998,4,1,1,6
14967,50,1,463.8,2,1,2,5
14968,30,1,147.59000000000003,3,1,1,5
14970,68,4,1592.06,2,3,4,9
14971,35,3,1097.98,3,3,3,9
14972,128,1,114.77,2,1,1,4
14973,107,3,1314.4499999999998,2,3,3,8
14974,37,1,89.94,3,1,1,5
14975,57,1,279.94,2,1,1,4
14976,57,6,774.86,2,4,3,9
14978,72,5,1921.3700000000003,2,4,4,10
14981,246,1,102.12,1,1,1,3
14984,19,2,202.37,3,2,1,6
14985,198,1,172.23999999999995,1,1,1,3
14987,16,1,163.2,4,1,1,6
14988,212,1,334.53999999999996,1,1,2,4
14995,39,2,231.98000000000002,3,2,1,6
14997,46,3,546.2,3,3,2,8
14998,170,2,414.87,1,2,2,5
15000,48,1,490.52000000000004,2,1,2,5
15002,116,3,1010.1100000000001,2,3,3,8
15004,147,1,1220.38,1,1,3,5
15005,16,26,5823.26,4,4,4,12
15006,51,1,475.43,2,1,2,5
15007,159,1,156.91000000000003,1,1,1,3
15009,12,3,1259.4299999999998,4,3,3,10
15010,36,1,308.94,3,1,2,6
15012,54,1,216.48000000000002,2,1,1,4
15014,43,2,257.66999999999996,3,2,1,6
15016,173,1,170.04,1,1,1,3
15017,34,1,125.58000000000001,3,1,1,5
15018,39,2,384.96000000000004,3,2,2,7
15019,267,1,252.81,1,1,1,3
15021,9,8,1673.6799999999998,4,4,4,12
15022,12,4,852.39,4,3,3,10
15023,3,10,6272.11,4,4,4,12
15024,10,8,1145.21,4,4,3,11
15025,33,1,361.96,3,1,2,6
15026,80,3,464.20000000000005,2,3,2,7
15027,31,4,1066.15,3,3,3,9
15028,8,3,441.16,4,3,2,9
15030,72,2,518.28,2,2,2,6
15031,4,4,653.19,4,3,2,9
15032,256,1,2188.5,1,1,4,6
15033,5,10,2553.88,4,4,4,12
15034,16,7,3453.7599999999998,4,4,4,12
15035,90,1,252.73000000000002,2,1,1,4
15036,72,3,429.56,2,3,2,7
15038,59,5,566.8599999999999,2,4,2,8
15039,10,45,18474.93,4,4,4,12
15041,170,1,179.92999999999998,1,1,1,3
15042,199,1,135.93,1,1,1,3
15043,31,1,537.0,3,1,2,6
15044,19,13,5545.18,3,4,4,11
15045,152,2,735.6600000000001,1,2,3,6
15046,9,15,5071.469999999999,4,4,4,12
15047,270,1,343.61999999999995,1,1,2,4
15048,65,3,282.3,2,3,1,6
15049,274,1,121.17000000000002,1,1,1,3
15050,25,3,1737.69,3,3,4,10
15051,23,3,1383.3600000000001,3,3,3,9
15052,319,1,207.73000000000002,1,1,1,3
15053,5,3,693.9499999999999,4,3,3,10
15054,12,2,302.1,4,2,2,8
15057,275,2,1489.5,1,2,3,6
15058,25,11,2102.54,3,4,4,11
15059,41,9,1337.7199999999998,3,4,3,10
15060,8,4,293.00000000000006,4,3,1,8
15061,4,36,34583.479999999996,4,4,4,12
15062,71,3,778.7800000000001,2,3,3,8
15063,213,1,370.79999999999995,1,1,2,4
15065,38,4,3158.13,3,3,4,10
15066,53,1,893.59,2,1,3,6
15067,78,3,1744.76,2,3,4,9
15068,46,2,553.36,3,2,2,7
15069,179,1,1109.5300000000002,1,1,3,5
15071,94,2,982.07,2,2,3,7
15073,10,3,1043.4099999999999,4,3,3,10
15074,105,1,735.6700000000001,2,1,3,6
15075,78,1,773.03,2,1,3,6
15076,173,1,880.8499999999999,1,1,3,5
15078,7,28,8924.46,4,4,4,12
15079,213,3,753.66,1,3,3,7
15081,22,4,393.65,3,3,2,8
15083,257,1,88.19999999999999,1,1,1,3
15087,282,1,306.94,1,1,2,4
15088,21,2,1160.0699999999997,3,2,3,8
15089,10,6,2420.84,4,4,4,12
15090,308,1,381.32,1,1,2,4
15091,68,1,480.71,2,1,2,5
15092,215,2,457.80999999999995,1,2,2,5
15093,18,5,3973.29,3,4,4,11
15095,104,4,1370.6,2,3,3,8
15096,43,1,219.39,3,1,1,5
15097,4,1,248.07999999999998,4,1,1,6
15098,182,3,39916.5,1,3,4,8
15099,84,1,410.48,2,1,2,5
15100,334,1,175.2,1,1,1,3
15101,9,1,215.25,4,1,1,6
15103,31,2,703.3599999999999,3,2,3,8
15104,197,2,993.5400000000001,1,2,3,6
15105,18,7,2298.9300000000003,3,4,4,11
15106,18,5,1422.52,3,4,3,10
15107,311,4,142.45,1,3,1,5
15108,142,3,1159.25,1,3,3,7
15109,246,1,484.9500000000001,1,1,2,4
15110,24,4,996.1,3,3,3,9
15111,29,2,1278.9799999999998,3,2,3,8
15113,10,3,3509.04,4,3,4,11
15114,30,10,2760.5599999999995,3,4,4,11
15115,18,1,340.11,3,1,2,6
15116,18,4,1352.75,3,3,3,9
15117,15,5,1551.7800000000002,4,4,3,11
15118,134,1,244.8,1,1,1,3
15119,246,1,266.4,1,1,1,3
15120,134,1,358.8199999999999,1,1,2,4
15121,50,2,457.72,2,2,2,6
15122,114,3,1633.7799999999997,2,3,4,9
15123,7,2,2199.3100000000004,4,2,4,10
15124,23,2,184.19000000000003,3,2,1,6
15125,25,15,11528.480000000001,3,4,4,11
15127,66,1,406.53000000000003,2,1,2,5
15128,60,4,1471.0,2,3,3,8
15129,50,11,3447.4,2,4,4,10
15130,170,1,330.11000000000007,1,1,2,4
15132,18,5,977.93,3,4,3,10
15133,128,3,982.4199999999998,1,3,3,7
15134,15,8,1387.99,4,4,3,11
15135,239,1,139.04999999999998,1,1,1,3
15136,3,4,1286.7000000000003,4,3,3,10
15139,240,2,178.96,1,2,1,4
15140,52,7,2354.25,2,4,4,10
15142,46,1,498.74000000000007,3,1,2,6
15143,226,1,259.45,1,1,1,3
15144,8,17,6580.4400000000005,4,4,4,12
15145,4,4,1194.7300000000002,4,3,3,10
15146,165,2,1327.16,1,2,3,6
15147,240,1,623.5,1,1,2,4
15148,11,1,301.29,4,1,1,6
15149,134,1,520.8,1,1,2,4
15150,17,10,5291.33,4,4,4,12
15152,10,13,4745.6900000000005,4,4,4,12
15153,31,1,329.25,3,1,2,6
15154,75,1,254.27999999999997,2,1,1,4
15156,1,3,961.4899999999999,4,3,3,10
15157,4,2,850.61,4,2,3,9
15158,45,1,401.4000000000001,3,1,2,6
15159,2,28,16780.030000000002,4,4,4,12
15163,18,2,304.4699999999999,3,2,2,7
15164,69,3,824.58,2,3,3,8
15167,321,1,158.79999999999998,1,1,1,3
15168,26,1,106.56,3,1,1,5
15171,331,1,1289.5,1,1,3,5
15172,9,5,1624.05,4,4,4,12
15174,323,1,135.75,1,1,1,3
15175,72,1,224.14000000000004,2,1,1,4
15178,260,1,40.5,1,1,1,3
15179,18,5,2206.9500000000003,3,4,4,11
15181,66,3,689.48,2,3,3,8
15182,154,2,622.8499999999998,1,2,2,5
15184,29,2,402.2,3,2,2,7
15185,70,1,310.62,2,1,2,5
15186,14,2,411.41,4,2,2,8
15187,2,15,4762.18,4,4,4,12
15189,1,41,16225.390000000003,4,4,4,12
15192,120,2,729.32,2,2,3,7
15193,61,1,499.31999999999994,2,1,2,5
15194,3,12,6057.540000000001,4,4,4,12
15195,3,1,3861.0,4,1,4,9
15197,11,2,523.11,4,2,2,8
15198,92,2,193.64,2,2,1,5
15199,59,4,1268.6999999999998,2,3,3,8
15201,87,5,1236.54,2,4,3,9
15203,26,6,1827.8,3,4,4,11
15205,85,2,653.24,2,2,2,6
15206,10,4,420.3,4,3,2,9
15208,1,4,804.72,4,3,3,10
15210,225,1,331.18,1,1,2,4
15211,60,1,511.34000000000003,2,1,2,5
15212,241,1,101.79999999999998,1,1,1,3
15213,319,2,328.35,1,2,2,5
15214,2,8,1661.44,4,4,4,12
15215,47,3,734.9399999999999,3,3,3,9
15216,88,1,96.6,2,1,1,4
15218,11,11,5756.89,4,4,4,12
15219,176,1,305.75,1,1,2,4
15220,52,6,1778.9599999999996,2,4,4,10
15222,319,1,585.0,1,1,2,4
15223,226,2,755.75,1,2,3,6
15225,234,1,409.4000000000001,1,1,2,4
15226,311,1,154.41,1,1,1,3
15227,37,5,1219.4,3,4,3,10
15228,66,4,3386.71,2,3,4,9
15230,239,2,429.6,1,2,2,5
15232,113,2,612.0600000000001,2,2,2,6
15234,277,1,197.00000000000006,1,1,1,3
15235,218,9,1552.8700000000003,1,4,3,8
15236,299,1,321.04999999999995,1,1,2,4
15237,2,4,1412.3200000000002,4,3,3,10
15238,29,3,1071.99,3,3,3,9
15239,10,2,780.59,4,2,3,9
15240,45,5,1706.57,3,4,4,11
15241,67,8,1756.44,2,4,4,10
15243,74,1,316.68,2,1,2,5
15244,65,2,631.5699999999999,2,2,2,6
15245,134,3,2515.84,1,3,4,8
15246,238,1,328.15,1,1,2,4
15247,122,1,356.0,2,1,2,5
15249,32,13,6688.459999999999,3,4,4,11
15251,9,11,10484.99,4,4,4,12
15252,36,2,740.78,3,2,3,8
15253,16,5,918.1999999999998,4,4,3,11
15254,127,1,300.36000000000007,2,1,1,4
15255,67,1,890.85,2,1,3,6
15256,149,1,98.45,1,1,1,3
15257,283,1,317.15,1,1,2,4
15258,169,2,623.1600000000001,1,2,2,5
15260,100,5,1390.27,2,4,3,9
15261,135,1,254.81999999999996,1,1,1,3
15262,324,1,178.95000000000002,1,1,1,3
15263,107,1,156.50999999999996,2,1,1,4
15264,64,1,393.7400000000001,2,1,2,5
15265,151,2,1506.12,1,2,3,6
15266,338,1,119.30000000000001,1,1,1,3
15267,22,5,1717.36,3,4,4,11
15269,24,1,408.8,3,1,2,6
15270,16,7,2379.49,4,4,4,12
15271,7,14,2381.59,4,4,4,12
15272,57,2,721.94,2,2,3,7
15274,4,2,716.57,4,2,3,9
15275,38,1,615.14,3,1,2,6
15276,66,1,128.63,2,1,1,4
15277,47,1,255.89999999999998,3,1,1,5
15280,172,1,113.12,1,1,1,3
15281,59,9,2332.1499999999996,2,4,4,10
15286,50,1,240.55,2,1,1,4
15287,22,2,486.69,3,2,2,7
15288,43,4,2140.87,3,3,4,10
15289,29,3,939.78,3,3,3,9
15290,5,17,7723.62,4,4,4,12
15291,26,12,3974.4000000000005,3,4,4,11
15292,201,1,178.39,1,1,1,3
15296,51,6,3672.8599999999997,2,4,4,10
15297,10,3,641.94,4,3,2,9
15298,2,11,4402.3,4,4,4,12
15299,67,3,2072.0,2,3,4,9
15300,64,1,496.43999999999994,2,1,2,5
15301,51,11,4376.58,2,4,4,10
15303,290,1,574.02,1,1,2,4
15304,61,7,571.25,2,4,2,8
15306,64,3,1174.35,2,3,3,8
15307,96,1,205.3,2,1,1,4
15308,274,1,310.46999999999997,1,1,2,4
15311,1,82,57972.73999999999,4,4,4,12
15312,75,3,635.11,2,3,2,7
15313,110,1,52.0,2,1,1,4
15314,199,1,327.96999999999997,1,1,2,4
15315,64,2,570.5000000000001,2,2,2,6
15316,327,1,165.0,1,1,1,3
15318,4,1,312.62,4,1,2,7
15319,284,1,204.5,1,1,1,3
15320,44,1,267.13000000000005,3,1,1,5
15321,71,3,2748.3100000000004,2,3,4,9
15322,86,1,679.68,2,1,3,6
15325,104,1,161.74,2,1,1,4
15326,334,1,311.7099999999999,1,1,2,4
15327,53,1,208.75,2,1,1,4
15329,39,3,1049.7,3,3,3,9
15330,32,2,714.9599999999999,3,2,3,8
15333,208,1,1028.56,1,1,3,5
15334,157,3,347.87,1,3,2,6
15335,54,1,170.22,2,1,1,4
15339,66,2,574.0699999999999,2,2,2,6
15341,81,1,2020.52,2,1,4,7
15342,130,1,406.09,1,1,2,4
15343,87,1,364.5,2,1,2,5
15344,1,3,563.9399999999999,4,3,2,9
15345,46,1,393.53999999999996,3,1,2,6
15346,333,1,252.42000000000002,1,1,1,3
15348,72,1,158.04,2,1,1,4
15349,158,2,463.9099999999999,1,2,2,5
15351,12,6,1659.99,4,4,4,12
15353,255,1,458.47,1,1,2,4
15355,29,2,277.05000000000007,3,2,1,6
15356,31,8,2379.11,3,4,4,11
15358,5,20,7722.65,4,4,4,12
15360,40,1,427.92999999999995,3,1,2,6
15364,96,2,913.1900000000002,2,2,3,7
15365,26,7,2314.32,3,4,4,11
15366,75,1,496.97,2,1,2,5
15367,57,4,1877.5900000000004,2,3,4,9
15368,21,1,446.94000000000005,3,1,2,6
15370,41,7,2386.05,3,4,4,11
15372,137,1,2007.4,1,1,4,6
15373,8,10,1878.81,4,4,4,12
15374,129,1,168.0,1,1,1,3
15376,40,3,1221.5599999999997,3,3,3,9
15379,169,6,2211.83,1,4,4,9
15380,9,4,1460.16,4,3,3,10
15381,214,2,596.85,1,2,2,5
15382,15,6,5955.709999999999,4,4,4,12
15384,170,1,338.83999999999986,1,1,2,4
15385,40,1,316.88,3,1,2,6
15386,186,1,394.14,1,1,2,4
15388,270,1,140.54,1,1,1,3
15389,172,1,500.0,1,1,2,4
15392,5,3,1196.5500000000002,4,3,3,10
15393,16,2,231.86,4,2,1,7
15394,10,3,1595.8799999999999,4,3,4,11
15395,326,1,107.45000000000002,1,1,1,3
15396,113,1,288.17999999999995,2,1,1,4
15397,290,1,94.0,1,1,1,3
15398,16,2,1345.5300000000002,4,2,3,9
15399,1,3,815.77,4,3,3,10
15400,92,5,716.2,2,4,3,9
15402,149,2,626.35,1,2,2,5
15405,189,1,349.1,1,1,2,4
15406,31,2,510.71000000000004,3,2,2,7
15407,34,4,1046.74,3,3,3,9
15408,264,1,267.18,1,1,1,3
15410,84,8,3450.8400000000006,2,4,4,10
15411,26,4,1348.9300000000003,3,3,3,9
15412,171,1,190.53,1,1,1,3
15414,10,3,774.9,4,3,3,10
15415,313,1,559.6099999999998,1,1,2,4
15416,65,4,3984.3199999999997,2,3,4,9
15417,85,1,508.80000000000007,2,1,2,5
15419,25,1,135.85999999999999,3,1,1,5
15421,59,4,950.36,2,3,3,8
15422,323,2,97.7,1,2,1,4
15423,38,1,43.5,3,1,1,5
15424,254,2,383.34000000000003,1,2,2,5
15426,19,4,1021.5000000000002,3,3,3,9
15427,33,3,1430.54,3,3,3,9
15428,15,1,93.78,4,1,1,6
15429,27,2,397.35,3,2,2,7
15432,23,1,171.19,3,1,1,5
15433,214,2,533.3,1,2,2,5
15434,8,5,1041.48,4,4,3,11
15435,22,1,149.29000000000002,3,1,1,5
15436,12,3,1067.75,4,3,3,10
15437,262,1,200.16,1,1,1,3
15438,131,1,156.57999999999998,1,1,1,3
15440,55,3,383.68,2,3,2,7
15442,249,1,594.0,1,1,2,4
15443,2,7,3213.59,4,4,4,12
15444,9,2,1411.2100000000003,4,2,3,9
15445,264,1,113.5,1,1,1,3
15447,331,1,155.17,1,1,1,3
15448,313,1,494.64,1,1,2,4
15449,26,3,974.5200000000001,3,3,3,9
15450,30,1,429.84,3,1,2,6
15452,30,3,528.48,3,3,2,8
15453,2,7,1371.77,4,4,3,11
15456,283,2,203.36999999999998,1,2,1,4
15457,262,1,237.07,1,1,1,3
15458,25,1,161.64,3,1,1,5
15462,94,3,234.6,2,3,1,6
15463,29,1,126.14,3,1,1,5
15464,338,1,1044.65,1,1,3,5
15465,20,16,6486.77,3,4,4,11
15466,85,1,334.53000000000003,2,1,2,5
15467,9,3,524.88,4,3,2,9
15468,51,2,467.51,2,2,2,6
15469,50,2,538.5500000000001,2,2,2,6
15471,2,1,454.48,4,1,2,7
15472,113,1,371.5600000000001,2,1,2,5
15473,14,7,1771.2,4,4,4,12
15475,77,1,454.10999999999996,2,1,2,5
15478,40,2,1399.9199999999998,3,2,3,8
15480,116,1,905.5,2,1,3,6
15482,16,9,10291.32,4,4,4,12
15483,161,4,225.26000000000002,1,3,1,5
15484,1,4,3590.4100000000003,4,3,4,11
15485,30,2,1624.9100000000003,3,2,4,9
15488,93,1,91.32000000000001,2,1,1,4
15489,23,3,1134.28,3,3,3,9
15491,95,6,3100.09,2,4,4,10
15492,28,2,659.4599999999998,3,2,3,8
15493,33,5,1953.4099999999999,3,4,4,11
15494,21,2,1280.58,3,2,3,8
15497,18,2,1262.2,3,2,3,8
15498,3,25,12339.68,4,4,4,12
15500,8,4,1131.5600000000002,4,3,3,10
15502,16,7,5994.579999999999,4,4,4,12
15504,81,1,52.83,2,1,1,4
15505,53,5,3610.96,2,4,4,10
15506,23,3,972.0799999999999,3,3,3,9
15507,172,1,475.86000000000007,1,1,2,4
15508,189,6,1000.2700000000001,1,4,3,8
15510,331,1,250.0,1,1,1,3
15511,12,5,900.53,4,4,3,11
15512,156,1,19.799999999999997,1,1,1,3
15513,33,17,13444.720000000001,3,4,4,11
15514,12,7,2199.0099999999998,4,4,4,12
15516,45,3,62.43,3,3,1,7
15517,233,1,267.03000000000003,1,1,1,3
15518,64,8,1921.5500000000002,2,4,4,10
15520,2,1,343.5,4,1,2,7
15521,40,8,3000.2000000000003,3,4,4,11
15522,33,2,397.98999999999995,3,2,2,7
15523,84,1,412.01,2,1,2,5
15524,25,1,440.0,3,1,2,6
15525,2,2,456.93999999999994,4,2,2,8
15526,33,2,148.44,3,2,1,6
15527,19,7,2207.13,3,4,4,11
15528,254,1,229.32999999999998,1,1,1,3
15529,23,9,3638.59,3,4,4,11
15530,22,4,1497.3100000000002,3,3,3,9
15531,8,2,1972.3899999999999,4,2,4,10
15532,25,3,1201.0300000000002,3,3,3,9
15533,19,3,807.57,3,3,3,9
15535,173,4,502.90000000000003,1,3,2,6
15537,163,1,110.92000000000002,1,1,1,3
15539,7,1,538.46,4,1,2,7
15540,11,1,213.30000000000004,4,1,1,6
15541,114,1,85.13,2,1,1,4
15543,288,1,127.86,1,1,1,3
15544,9,8,3192.17,4,4,4,12
15545,54,1,153.64000000000001,2,1,1,4
15547,7,13,4143.23,4,4,4,12
15549,77,3,1677.7099999999998,2,3,4,9
15550,4,4,575.6300000000002,4,3,2,9
15551,37,1,436.05999999999995,3,1,2,6
15552,217,1,90.12,1,1,1,3
15553,60,1,428.92999999999995,2,1,2,5
15554,278,1,217.2,1,1,1,3
15555,12,13,3803.2999999999997,4,4,4,12
15556,24,1,279.77,3,1,1,5
15557,29,1,468.90999999999997,3,1,2,6
15561,12,4,800.5899999999999,4,3,3,10
15563,22,2,1091.25,3,2,3,8
15565,50,2,173.16000000000003,2,2,1,5
15567,19,1,186.01000000000002,3,1,1,5
15568,3,3,758.29,4,3,3,10
15569,104,5,1375.71,2,4,3,9
15570,7,9,3100.88,4,4,4,12
15571,12,4,650.4300000000001,4,3,2,9
15572,5,7,2533.42,4,4,4,12
15573,32,2,583.24,3,2,2,7
15574,178,1,112.1,1,1,1,3
15576,38,1,921.37,3,1,3,7
15577,151,3,258.88000000000005,1,3,1,5
15578,162,1,127.1,1,1,1,3
15579,69,2,327.59999999999997,2,2,2,6
15581,156,6,393.57000000000005,1,4,2,7
15582,25,3,682.9100000000001,3,3,3,9
15584,24,4,720.8600000000001,3,3,3,9
15585,177,1,455.29999999999995,1,1,2,4
15587,50,3,568.8000000000001,2,3,2,7
15589,256,3,478.53,1,3,2,6
15592,47,1,388.58,3,1,2,6
15593,71,1,199.8,2,1,1,4
15594,16,5,1771.7800000000002,4,4,4,12
15596,101,4,1004.27,2,3,3,8
15597,35,1,324.57,3,1,2,6
15598,53,1,240.68,2,1,1,4
15599,27,2,761.74,3,2,3,8
15601,11,12,5540.110000000001,4,4,4,12
15602,8,7,1145.3200000000002,4,4,3,11
15603,79,1,48.480000000000004,2,1,1,4
15604,52,1,216.39,2,1,1,4
15605,36,4,1003.38,3,3,3,9
15606,61,9,2920.16,2,4,4,10
15607,337,1,104.76,1,1,1,3
15608,28,4,1093.68,3,3,3,9
15609,184,1,298.48,1,1,1,3
15610,52,1,112.46,2,1,1,4
15611,10,11,1570.45,4,4,3,11
15612,36,2,195.15,3,2,1,6
15615,10,20,9318.55,4,4,4,12
15618,33,4,776.8510000000002,3,3,3,9
15619,11,1,336.40000000000003,4,1,2,7
15620,57,2,1128.69,2,2,3,7
15621,4,4,1293.03,4,3,3,10
15622,43,9,3709.5600000000004,3,4,4,11
15623,141,1,301.03,1,1,1,3
15624,117,4,588.13,2,3,2,7
15625,104,4,1534.26,2,3,3,8
15626,75,2,675.8000000000001,2,2,3,7
15628,5,8,2551.06,4,4,4,12
15630,45,2,1186.35,3,2,3,8
15632,16,8,3285.3100000000004,4,4,4,12
15634,17,1,243.55,4,1,1,6
15636,90,2,724.76,2,2,3,7
15637,53,1,223.36,2,1,1,4
15639,134,1,425.32,1,1,2,4
15640,4,12,9704.37,4,4,4,12
15641,105,3,1578.83,2,3,3,8
15643,192,3,664.0,1,3,3,7
15644,166,4,803.54,1,3,3,7
15645,19,1,611.59,3,1,2,6
15646,158,2,257.84,1,2,1,4
15648,204,2,639.5,1,2,2,5
15649,336,1,306.0,1,1,2,4
15651,37,3,646.3,3,3,2,8
15652,91,1,337.74,2,1,2,5
15653,93,2,877.4399999999999,2,2,3,7
15654,9,2,922.5300000000001,4,2,3,9
15655,243,1,560.6700000000001,1,1,2,4
15656,45,4,748.5,3,3,3,9
15657,23,1,30.0,3,1,1,5
15658,190,4,717.9,1,3,3,7
15659,44,1,306.45000000000005,3,1,2,6
15660,25,8,1391.56,3,4,3,10
15661,317,2,309.8,1,2,2,5
15663,106,1,138.14,2,1,1,4
15664,51,1,386.43,2,1,2,5
15665,168,2,2222.2099999999996,1,2,4,7
15667,40,1,301.32000000000005,3,1,2,6
15668,218,1,76.32000000000001,1,1,1,3
15669,40,4,684.34,3,3,3,9
15670,297,1,173.05,1,1,1,3
15671,19,7,2657.13,3,4,4,11
15673,88,4,2726.2300000000005,2,3,4,9
15674,73,4,2111.8900000000003,2,3,4,9
15675,81,3,323.69,2,3,2,7
15676,19,3,3435.7599999999998,3,3,4,10
15677,49,1,657.23,2,1,3,6
15678,53,1,352.70000000000005,2,1,2,5
15679,24,4,781.2800000000001,3,3,3,9
15680,9,2,854.79,4,2,3,9
15681,25,5,1426.16,3,4,3,10
15683,117,1,193.75,2,1,1,4
15687,9,9,2993.1,4,4,4,12
15689,120,1,150.6,2,1,1,4
15690,4,2,239.76,4,2,1,7
15691,252,1,136.8,1,1,1,3
15692,28,1,191.03999999999996,3,1,1,5
15694,1,11,5632.07,4,4,4,12
15695,267,2,409.98,1,2,2,5
15696,33,8,2711.1099999999997,3,4,4,11
15699,18,1,309.6499999999999,3,1,2,6
15700,172,2,696.6799999999998,1,2,3,6
15701,2,4,1529.0,4,3,3,10
15703,265,1,211.5,1,1,1,3
15704,140,4,2293.62,1,3,4,8
15705,201,1,143.10000000000002,1,1,1,3
15706,64,4,1060.56,2,3,3,8
15707,35,4,916.9799999999998,3,3,3,9
15708,41,6,2917.96,3,4,4,11
15709,284,1,133.25,1,1,1,3
15712,9,5,1072.36,4,4,3,11
15713,143,1,185.54999999999998,1,1,1,3
15714,12,2,330.03,4,2,2,8
15716,146,3,571.71,1,3,2,6
15717,234,1,150.3,1,1,1,3
15719,33,13,5028.42,3,4,4,11
15720,24,1,598.73,3,1,2,6
15721,12,1,471.4000000000001,4,1,2,7
15722,36,5,2211.2100000000005,3,4,4,11
15724,201,2,218.25,1,2,1,4
15725,15,1,415.25,4,1,2,7
15727,17,6,3642.1099999999997,4,4,4,12
15729,213,1,85.0,1,1,1,3
15730,66,3,1120.88,2,3,3,8
15732,212,1,156.01999999999998,1,1,1,3
15733,283,1,162.3,1,1,1,3
15734,115,2,1339.45,2,2,3,7
15737,15,8,1188.12,4,4,3,11
15738,19,15,4482.769999999999,3,4,4,11
15739,66,1,449.12,2,1,2,5
15740,49,1,154.88000000000002,2,1,1,4
15743,16,4,775.9599999999999,4,3,3,10
15744,78,1,34.8,2,1,1,4
15745,19,4,1094.59,3,3,3,9
15746,134,1,196.88000000000002,1,1,1,3
15747,13,3,946.6399999999999,4,3,3,10
15748,40,1,144.35999999999999,3,1,1,5
15749,235,3,44534.3,1,3,4,8
15750,3,6,2122.5299999999997,4,4,4,12
15752,40,6,2366.9500000000003,3,4,4,11
15753,305,1,79.2,1,1,1,3
15754,51,3,458.57,2,3,2,7
15755,10,6,2364.25,4,4,4,12
15756,61,4,528.01,2,3,2,7
15757,66,2,714.4200000000001,2,2,3,7
15758,25,1,205.25,3,1,1,5
15759,218,2,155.8,1,2,1,4
15762,65,2,583.75,2,2,2,6
15763,32,2,1086.9200000000003,3,2,3,8
15764,88,6,3279.97,2,4,4,10
15766,64,1,315.05999999999995,2,1,2,5
15768,116,3,621.83,2,3,2,7
15769,7,25,56160.92,4,4,4,12
15773,6,1,635.6800000000001,4,1,2,7
15774,69,1,270.79999999999995,2,1,1,4
15775,245,1,104.9,1,1,1,3
15776,133,1,241.61999999999998,1,1,1,3
15777,241,3,681.56,1,3,3,7
15780,184,2,298.12999999999994,1,2,1,4
15781,25,3,345.46000000000004,3,3,2,8
15782,10,3,2614.7400000000002,4,3,4,11
15783,11,1,246.3,4,1,1,6
15785,33,5,2328.9700000000003,3,4,4,11
15786,46,3,4919.0,3,3,4,10
15787,26,3,933.26,3,3,3,9
15790,10,1,218.75000000000003,4,1,1,6
15791,44,2,1612.69,3,2,4,9
15793,15,3,965.6099999999999,4,3,3,10
15795,150,1,610.01,1,1,2,4
15796,1,8,2707.61,4,4,4,12
15797,113,3,2192.4,2,3,4,9
15799,76,3,884.14,2,3,3,8
15800,107,2,696.89,2,2,3,7
15801,46,3,1063.95,3,3,3,9
15803,51,1,415.82000000000005,2,1,2,5
15804,1,13,4206.389999999999,4,4,4,12
15805,23,16,5117.380000000001,3,4,4,11
15806,46,3,784.5799999999999,3,3,3,9
15807,50,3,903.9000000000001,2,3,3,8
15808,306,2,1469.8200000000002,1,2,3,6
15809,36,5,515.77,3,4,2,9
15810,79,4,1391.98,2,3,3,8
15811,22,4,1779.82,3,3,4,10
15812,107,5,1801.14,2,4,4,10
15813,208,2,1303.9099999999999,1,2,3,6
15814,17,4,1945.33,4,3,4,11
15815,64,5,2100.6,2,4,4,10
15819,49,4,1905.4500000000003,2,3,4,9
15820,320,1,206.98,1,1,1,3
15821,44,2,570.9599999999999,3,2,2,7
15822,3,1,445.27,4,1,2,7
15825,172,1,532.94,1,1,2,4
15826,56,3,1654.3100000000002,2,3,4,9
15827,73,12,1645.16,2,4,4,10
15829,99,2,636.1399999999998,2,2,2,6
15830,38,1,576.0,3,1,2,6
15831,58,3,794.64,2,3,3,8
15832,254,1,836.7900000000001,1,1,3,5
15834,70,4,2222.65,2,3,4,9
15835,44,4,954.09,3,3,3,9
15836,50,1,137.37,2,1,1,4
15837,65,1,391.98,2,1,2,5
15838,11,18,32685.579999999994,4,4,4,12
15839,33,3,1048.49,3,3,3,9
15840,59,2,355.55999999999995,2,2,2,6
15841,73,4,1224.06,2,3,3,8
15843,304,1,118.95000000000002,1,1,1,3
15844,46,1,130.73999999999998,3,1,1,5
15845,18,8,3711.77,3,4,4,11
15847,38,2,389.2699999999999,3,2,2,7
15850,19,2,234.88,3,2,1,6
15852,187,2,160.70999999999998,1,2,1,4
15853,52,1,110.80000000000001,2,1,1,4
15854,4,11,2739.02,4,4,4,12
15855,137,5,712.24,1,4,3,8
15856,4,24,12861.07,4,4,4,12
15857,19,1,296.99999999999994,3,1,1,5
15858,16,4,1043.6399999999999,4,3,3,10
15860,41,7,862.4999999999999,3,4,3,10
15861,12,8,3146.92,4,4,4,12
15862,8,3,478.65,4,3,2,9
15863,26,2,68.84,3,2,1,6
15864,22,6,1936.3200000000004,3,4,4,11
15865,41,3,895.13,3,3,3,9
15866,101,1,211.89,2,1,1,4
15867,5,12,3247.63,4,4,4,12
15869,277,2,149.64000000000001,1,2,1,4
15870,33,1,351.44000000000005,3,1,2,6
15872,15,2,316.25000000000006,4,2,2,8
15874,64,7,4405.88,2,4,4,10
15877,2,2,490.33,4,2,2,8
15881,312,3,346.14000000000004,1,3,2,6
15882,199,2,145.04,1,2,1,4
15883,2,2,396.47999999999996,4,2,2,8
15885,93,1,349.35,2,1,2,5
15886,60,1,181.09000000000003,2,1,1,4
15888,81,1,162.64000000000001,2,1,1,4
15889,157,1,132.1,1,1,1,3
15891,227,1,509.13,1,1,2,4
15894,253,1,106.81,1,1,1,3
15895,150,1,179.17000000000002,1,1,1,3
15897,194,2,208.59000000000003,1,2,1,4
15898,1,3,867.1899999999998,4,3,3,10
15900,24,1,337.28000000000003,3,1,2,6
15901,17,3,349.75000000000006,4,3,2,9
15903,10,7,5126.76,4,4,4,12
15904,8,1,164.67999999999998,4,1,1,6
15906,20,7,1567.6899999999998,3,4,3,10
15907,4,3,881.8700000000001,4,3,3,10
15909,174,1,191.93999999999997,1,1,1,3
15910,1,8,1228.88,4,4,3,11
15912,178,2,264.61999999999995,1,2,1,4
15916,16,6,1270.4100000000003,4,4,3,11
15917,248,1,123.10000000000001,1,1,1,3
15918,191,2,334.23,1,2,2,5
15919,20,1,311.61,3,1,2,6
15920,154,3,163.54999999999998,1,3,1,5
15921,173,1,323.03,1,1,2,4
15925,194,1,207.14999999999998,1,1,1,3
15930,67,1,426.63000000000005,2,1,2,5
15932,4,8,2495.8700000000003,4,4,4,12
15933,21,3,1107.4600000000003,3,3,3,9
15935,239,1,108.03999999999999,1,1,1,3
15937,64,1,145.35,2,1,1,4
15938,112,5,404.58,2,4,2,8
15939,90,15,6115.009999999999,2,4,4,10
15940,311,1,35.8,1,1,1,3
15942,134,1,337.43999999999994,1,1,2,4
15944,277,1,325.1,1,1,2,4
15947,83,1,1708.24,2,1,4,7
15948,8,2,955.2400000000001,4,2,3,9
15949,17,2,364.72,4,2,2,8
15950,32,3,1315.89,3,3,3,9
15951,9,2,708.22,4,2,3,9
15952,34,4,781.9100000000001,3,3,3,9
15953,15,7,1449.54,4,4,3,11
15955,24,13,3843.8800000000006,3,4,4,11
15957,32,1,428.89000000000004,3,1,2,6
15958,74,1,104.35,2,1,1,4
15963,20,2,470.76000000000005,3,2,2,7
15965,17,3,652.68,4,3,2,9
15967,23,2,395.13,3,2,2,7
15969,3,3,666.0999999999999,4,3,3,10
15970,304,1,314.1,1,1,2,4
15971,18,12,4194.9,3,4,4,11
15974,39,7,3442.15,3,4,4,11
15975,84,1,371.01,2,1,2,5
15976,165,2,427.64000000000004,1,2,2,5
15977,17,2,1054.73,4,2,3,9
15978,77,1,1098.78,2,1,3,6
15980,89,3,2398.8599999999997,2,3,4,9
15981,25,8,3408.48,3,4,4,11
15983,22,1,326.75,3,1,2,6
15984,3,9,2657.9300000000003,4,4,4,12
15985,123,2,1142.4199999999998,2,2,3,7
15986,30,1,168.11999999999998,3,1,1,5
15987,12,6,1319.29,4,4,3,11
15988,19,1,156.78,3,1,1,5
15990,44,2,792.1100000000001,3,2,3,8
15992,4,1,41.989999999999995,4,1,1,6
15993,9,7,2768.9700000000003,4,4,4,12
15994,55,1,414.27000000000004,2,1,2,5
15996,88,5,769.33,2,4,3,9
15998,37,4,2216.83,3,3,4,10
16000,3,3,12393.699999999999,4,3,4,11
16003,30,4,1554.37,3,3,3,9
16005,12,4,578.71,4,3,2,9
16006,211,1,101.4,1,1,1,3
16007,48,4,1693.81,2,3,4,9
16008,24,3,478.78000000000003,3,3,2,8
16009,22,4,972.1100000000001,3,3,3,9
16010,246,2,282.29999999999995,1,2,1,4
16011,8,14,2954.36,4,4,4,12
16012,35,3,1415.29,3,3,3,9
16013,4,42,34157.6,4,4,4,12
16014,38,3,646.8299999999999,3,3,2,8
16015,4,3,704.26,4,3,3,10
16016,3,7,1102.49,4,4,3,11
16017,47,1,211.88,3,1,1,5
16018,39,2,408.90000000000003,3,2,2,7
16019,47,8,3567.1400000000003,3,4,4,11
16020,17,3,851.01,4,3,3,10
16022,260,1,602.6300000000001,1,1,2,4
16023,46,3,719.81,3,3,3,9
16024,12,1,245.74999999999997,4,1,1,6
16025,30,1,439.65999999999997,3,1,2,6
16026,43,1,236.09,3,1,1,5
16027,92,6,934.6199999999999,2,4,3,9
16029,39,56,59595.57,3,4,4,11
16030,310,1,331.24,1,1,2,4
16031,92,2,547.9000000000001,2,2,2,6
16033,6,18,8471.08,4,4,4,12
16034,196,3,437.69999999999993,1,3,2,6
16036,87,2,758.9199999999998,2,2,3,7
16037,270,2,554.5600000000001,1,2,2,5
16038,8,3,471.78,4,3,2,9
16040,65,3,1313.5500000000002,2,3,3,8
16041,31,3,3166.4,3,3,4,10
16042,22,5,1177.47,3,4,3,10
16043,38,4,773.99,3,3,3,9
16045,120,4,1340.7,2,3,3,8
16049,40,3,1074.81,3,3,3,9
16050,174,1,137.89999999999998,1,1,1,3
16052,54,1,362.05999999999995,2,1,2,5
16053,33,2,1511.9500000000003,3,2,3,8
16054,145,1,783.9000000000001,1,1,3,5
16055,221,1,134.8,1,1,1,3
16056,45,1,650.75,3,1,2,6
16057,16,7,2263.12,4,4,4,12
16059,66,5,1334.91,2,4,3,9
16062,10,3,906.06,4,3,3,10
16063,260,1,335.32000000000005,1,1,2,4
16066,17,5,1521.0400000000004,4,4,3,11
16070,22,2,852.15,3,2,3,8
16071,45,1,326.24,3,1,2,6
16072,288,1,584.32,1,1,2,4
16073,297,1,122.39999999999999,1,1,1,3
16076,3,10,2234.73,4,4,4,12
16078,284,1,79.2,1,1,1,3
16079,17,3,1352.0000000000002,4,3,3,10
16080,82,2,217.16000000000003,2,2,1,5
16081,56,4,2641.8199999999997,2,3,4,9
16083,101,1,979.6400000000001,2,1,3,6
16084,299,1,436.18,1,1,2,4
16085,23,5,981.51,3,4,3,10
16086,59,4,944.1299999999999,2,3,3,8
16091,155,2,315.06,1,2,2,5
16092,115,3,817.86,2,3,3,8
16093,107,1,17.0,2,1,1,4
16094,12,4,1078.2299999999998,4,3,3,10
16096,264,1,320.62,1,1,2,4
16097,240,1,185.05,1,1,1,3
16098,88,6,1575.0300000000002,2,4,3,9
16099,50,3,731.8999999999997,2,3,3,8
16101,71,1,1290.6999999999998,2,1,3,6
16102,42,3,1842.14,3,3,4,10
16103,7,6,1429.6399999999999,4,4,3,11
16104,62,1,298.21000000000004,2,1,1,4
16105,249,1,336.96,1,1,2,4
16106,66,1,108.38,2,1,1,4
16107,18,7,3204.16,3,4,4,11
16108,85,1,842.5,2,1,3,6
16109,219,2,611.8800000000001,1,2,2,5
16110,45,3,1320.9500000000003,3,3,3,9
16112,143,4,195.74,1,3,1,5
16113,183,1,161.38,1,1,1,3
16114,171,1,135.75000000000003,1,1,1,3
16115,10,8,1660.8799999999999,4,4,4,12
16116,212,1,612.7800000000001,1,1,2,4
16117,190,1,232.21,1,1,1,3
16119,8,2,423.36,4,2,2,8
16120,59,4,1309.14,2,3,3,8
16121,57,2,854.66,2,2,3,7
16122,73,3,578.7,2,3,2,7
16123,52,1,307.78000000000003,2,1,2,5
16124,317,1,249.0,1,1,1,3
16126,29,4,6287.77,3,3,4,10
16127,39,1,656.25,3,1,3,7
16128,18,5,1880.2199999999998,3,4,4,11
16131,52,6,3506.540000000001,2,4,4,10
16133,4,33,14589.039999999999,4,4,4,12
16134,22,1,334.55999999999995,3,1,2,6
16135,263,1,517.5500000000001,1,1,2,4
16136,60,3,709.3800000000002,2,3,3,8
16139,19,3,635.4100000000001,3,3,2,8
16140,66,1,601.04,2,1,2,5
16141,88,1,620.4,2,1,2,5
16142,250,1,535.3399999999999,1,1,2,4
16143,3,4,1613.59,4,3,4,11
16144,247,1,175.2,1,1,1,3
16145,9,10,3496.7099999999996,4,4,4,12
16146,157,3,734.1299999999999,1,3,3,7
16147,134,1,374.99999999999994,1,1,2,4
16148,296,1,76.32000000000001,1,1,1,3
16149,5,2,280.52000000000004,4,2,1,7
16150,43,4,1659.6000000000001,3,3,4,10
16152,269,1,1829.0399999999997,1,1,4,6
16153,50,4,1609.22,2,3,4,9
16156,9,9,3092.04,4,4,4,12
16157,16,3,656.6899999999999,4,3,3,10
16159,282,1,348.2000000000001,1,1,2,4
16160,65,2,1025.44,2,2,3,7
16161,2,16,4957.37,4,4,4,12
16162,252,1,37.4,1,1,1,3
16163,232,1,415.00000000000006,1,1,2,4
16164,17,3,822.48,4,3,3,10
16168,11,26,3511.8000000000006,4,4,4,12
16169,8,4,1822.9700000000003,4,3,4,11
16170,51,6,1885.0500000000004,2,4,4,10
16171,59,1,73.2,2,1,1,4
16172,95,5,1140.2100000000003,2,4,3,9
16173,16,6,1418.32,4,4,3,11
16174,126,3,1009.55,2,3,3,8
16175,94,4,1037.5900000000001,2,3,3,8
16177,50,1,331.95,2,1,2,5
16178,138,1,197.9,1,1,1,3
16179,61,1,215.83,2,1,1,4
16180,100,8,10254.18,2,4,4,10
16181,73,1,305.5400000000001,2,1,2,5
16182,72,4,6617.65,2,3,4,9
16183,67,1,338.7100000000001,2,1,2,5
16184,64,6,1158.79,2,4,3,9
16185,17,2,529.4100000000001,4,2,2,8
16186,23,11,3699.26,3,4,4,11
16187,32,15,6911.4400000000005,3,4,4,11
16188,45,4,981.8599999999999,3,3,3,9
16189,16,2,215.47999999999996,4,2,1,7
16190,40,1,215.08,3,1,1,5
16191,3,11,4552.92,4,4,4,12
16193,237,1,314.45000000000005,1,1,2,4
16198,75,1,400.681,2,1,2,5
16200,4,2,1068.87,4,2,3,9
16201,3,4,1863.4700000000003,4,3,4,11
16203,59,3,422.20000000000005,2,3,2,7
16204,23,1,384.18,3,1,2,6
16205,31,4,751.03,3,3,3,9
16206,55,4,537.0600000000001,2,3,2,7
16207,25,1,394.38,3,1,2,6
16208,45,2,664.26,3,2,3,8
16209,89,5,2262.6199999999994,2,4,4,10
16210,2,13,14075.66,4,4,4,12
16211,89,1,547.0200000000001,2,1,2,5
16212,19,2,690.3399999999999,3,2,3,8
16213,79,1,159.0,2,1,1,4
16214,171,3,1062.75,1,3,3,7
16215,81,1,242.35000000000002,2,1,1,4
16216,267,1,914.9299999999998,1,1,3,5
16217,235,2,304.25000000000006,1,2,2,5
16218,30,6,2613.38,3,4,4,11
16221,37,2,694.12,3,2,3,8
16222,318,1,773.5500000000001,1,1,3,5
16224,57,4,1295.3,2,3,3,8
16225,45,5,1096.3200000000002,3,4,3,10
16226,203,3,255.12,1,3,1,5
16227,225,1,314.22,1,1,2,4
16229,87,2,1010.5999999999998,2,2,3,7
16230,190,2,542.03,1,2,2,5
16232,44,4,990.8799999999999,3,3,3,9
16233,71,2,389.28000000000003,2,2,2,6
16235,41,4,857.3099999999998,3,3,3,9
16236,78,1,432.19999999999993,2,1,2,5
16239,57,2,414.2,2,2,2,6
16240,24,2,3718.8,3,2,4,9
16241,10,12,2312.66,4,4,4,12
16242,8,7,3579.8599999999997,4,4,4,12
16243,34,2,409.1,3,2,2,7
16244,212,1,466.12,1,1,2,4
16245,24,3,1413.66,3,3,3,9
16247,170,1,114.56,1,1,1,3
16248,62,1,152.94,2,1,1,4
16249,53,5,1800.0700000000002,2,4,4,10
16250,261,1,163.3,1,1,1,3
16253,67,2,3683.8599999999997,2,2,4,8
16255,17,7,2245.66,4,4,4,12
16256,267,1,752.4300000000002,1,1,3,5
16257,177,1,21.95,1,1,1,3
16258,45,5,5203.510000000001,3,4,4,11
16260,51,1,1035.45,2,1,3,6
16261,17,4,728.5400000000001,4,3,3,10
16265,9,7,4506.1900000000005,4,4,4,12
16266,74,7,861.8899999999999,2,4,3,9
16268,71,2,617.6500000000001,2,2,2,6
16271,3,4,1271.42,4,3,3,10
16272,117,1,411.7,2,1,2,5
16275,197,1,559.87,1,1,2,4
16276,177,1,810.6000000000001,1,1,3,5
16278,100,1,566.38,2,1,2,5
16279,21,3,1502.78,3,3,3,9
16281,72,1,2062.0600000000004,2,1,4,7
16282,340,1,168.3,1,1,1,3
16283,6,5,1569.11,4,4,3,11
16284,31,2,812.68,3,2,3,8
16287,170,1,142.5,1,1,1,3
16292,122,1,302.25,2,1,2,5
16293,22,9,1870.2400000000002,3,4,4,11
16295,10,4,1328.5500000000004,4,3,3,10
16297,269,1,301.90000000000003,1,1,2,4
16298,23,3,598.1999999999999,3,3,2,8
16302,127,1,233.22,2,1,1,4
16303,26,3,5360.630000000001,3,3,4,10
16305,139,1,361.21999999999986,1,1,2,4
16306,214,5,564.1700000000002,1,4,2,7
16308,38,4,2560.0,3,3,4,10
16309,106,2,706.57,2,2,3,7
16311,18,2,616.26,3,2,2,7
16313,3,2,274.15000000000003,4,2,1,7
16315,331,1,226.37,1,1,1,3
16316,64,7,2630.6899999999996,2,4,4,10
16317,120,3,1341.65,2,3,3,8
16318,35,1,328.15,3,1,2,6
16319,218,1,404.40000000000003,1,1,2,4
16321,72,5,373.65,2,4,2,8
16322,1,2,326.74999999999994,4,2,2,8
16323,196,1,207.50000000000003,1,1,1,3
16324,128,3,408.58999999999986,1,3,2,6
16325,47,3,594.24,3,3,2,8
16326,6,14,3039.2200000000003,4,4,4,12
16327,14,5,3284.67,4,4,4,12
16330,18,3,251.91,3,3,1,7
16332,28,7,1582.8,3,4,3,10
16333,8,22,26626.8,4,4,4,12
16337,37,1,151.05,3,1,1,5
16338,157,1,214.8,1,1,1,3
16339,284,1,94.05000000000001,1,1,1,3
16340,107,1,534.31,2,1,2,5
16341,25,4,1971.87,3,3,4,10
16342,75,4,322.41,2,3,2,7
16343,16,2,328.58000000000004,4,2,2,8
16344,158,1,101.10000000000001,1,1,1,3
16345,44,1,565.46,3,1,2,6
16347,11,2,847.45,4,2,3,9
16348,32,7,1413.31,3,4,3,10
16349,291,1,53.5,1,1,1,3
16350,21,4,1116.47,3,3,3,9
16351,333,1,153.9,1,1,1,3
16352,18,2,494.44,3,2,2,7
16353,4,19,6165.71,4,4,4,12
16354,63,2,395.8,2,2,2,6
16356,198,3,211.77,1,3,1,5
16357,33,3,658.88,3,3,3,9
16358,1,4,2027.5,4,3,4,11
16359,7,9,1750.9200000000003,4,4,4,12
16360,5,6,3450.41,4,4,4,12
16361,10,4,891.21,4,3,3,10
16362,32,5,709.99,3,4,3,10
16363,53,1,109.36000000000001,2,1,1,4
16364,12,2,705.7899999999998,4,2,3,9
16365,18,7,1171.96,3,4,3,10
16366,19,1,327.3,3,1,2,6
16367,37,1,633.5799999999997,3,1,2,6
16368,2,2,479.90999999999997,4,2,2,8
16369,18,3,1543.3300000000002,3,3,3,9
16370,82,4,1301.9099999999999,2,3,3,8
16372,33,2,355.72999999999996,3,2,2,7
16374,66,2,458.78,2,2,2,6
16376,9,2,974.9599999999999,4,2,3,9
16377,267,1,676.2,1,1,3,5
16378,247,3,362.9500000000001,1,3,2,6
16379,4,4,2157.4000000000005,4,3,4,11
16380,61,1,1743.15,2,1,4,7
16383,75,2,643.7599999999999,2,2,2,6
16384,90,2,584.5,2,2,2,6
16385,60,2,407.66,2,2,2,6
16386,29,2,302.56999999999994,3,2,2,7
16387,323,1,94.36,1,1,1,3
16389,53,4,1382.0699999999997,2,3,3,8
16392,270,1,217.89,1,1,1,3
16393,2,11,2749.41,4,4,4,12
16394,57,5,1555.3400000000001,2,4,3,9
16395,61,5,1482.0600000000002,2,4,3,9
16398,154,2,1705.8,1,2,4,7
16399,19,2,406.22,3,2,2,7
16400,95,1,303.93,2,1,2,5
16401,1,12,4098.32,4,4,4,12
16402,265,1,87.8,1,1,1,3
16403,312,1,177.5,1,1,1,3
16404,70,1,443.05000000000007,2,1,2,5
16405,302,2,167.25,1,2,1,4
16406,19,1,154.35000000000002,3,1,1,5
16407,13,10,2079.6800000000003,4,4,4,12
16409,36,5,2022.9800000000002,3,4,4,11
16411,19,1,83.15,3,1,1,5
16412,54,1,135.99,2,1,1,4
16413,57,1,262.2,2,1,1,4
16414,22,2,126.25,3,2,1,6
16415,44,1,200.26999999999995,3,1,1,5
16416,27,3,1051.4,3,3,3,9
16418,45,3,631.1200000000001,3,3,2,8
16419,113,6,958.71,2,4,3,9
16422,17,48,32659.08,4,4,4,12
16423,25,1,346.12,3,1,2,6
16424,191,1,133.56,1,2,1,4
16425,302,1,302.69999999999993,1,2,2,5
16426,2,10,1863.76,4,4,4,12
16427,263,2,241.06,1,2,1,4
16429,106,1,284.55,2,2,1,5
16430,57,1,300.85,2,2,1,5
16431,213,3,623.2799999999999,1,3,2,6
16432,64,1,287.4,2,2,1,5
16433,28,1,184.26,3,2,1,6
16434,29,7,1511.8000000000002,3,4,3,10
16438,6,5,798.35,4,4,3,11
16440,8,5,3640.6699999999996,4,4,4,12
16441,67,2,381.2,2,2,2,6
16442,2,2,462.24000000000007,4,2,2,8
16444,46,4,654.6700000000001,3,3,2,8
16445,34,1,230.51000000000002,3,2,1,6
16446,1,2,168472.5,4,2,4,10
16447,136,1,255.91,1,2,1,4
16448,198,1,182.99,1,2,1,4
16449,198,2,707.69,1,2,3,6
16450,150,1,311.92,1,2,2,5
16451,88,1,266.97,2,2,1,5
16454,64,1,5.9,2,2,1,5
16455,64,4,1309.2,2,3,3,8
16456,99,4,1370.7799999999997,2,3,3,8
16457,218,1,208.35999999999999,1,2,1,4
16458,3,17,3288.84,4,4,4,12
16460,28,3,811.23,3,3,3,9
16461,178,1,142.92,1,2,1,4
16462,74,3,136.0,2,3,1,6
16463,21,4,1422.4,3,3,3,9
16464,20,3,1298.66,3,3,3,9
16466,34,7,1595.96,3,4,4,11
16468,74,1,74.9,2,2,1,5
16469,24,4,625.4200000000001,3,3,2,8
16470,52,3,536.43,2,3,2,7
16471,275,1,223.95,1,2,1,4
16473,165,3,316.11,1,3,2,6
16474,7,7,1810.49,4,4,4,12
16475,88,4,544.3,2,3,2,7
16477,64,5,1950.0600000000002,2,4,4,10
16478,25,3,331.0,3,3,2,8
16479,10,2,300.83,4,2,1,7
16480,76,1,769.29,2,2,3,7
16482,16,1,220.62,4,2,1,7
16483,192,1,139.35,1,2,1,4
16484,174,2,404.30000000000007,1,2,2,5
16485,77,1,363.65,2,2,2,6
16488,33,3,498.79999999999995,3,3,2,8
16491,47,1,731.5,3,2,3,8
16493,80,4,1351.63,2,3,3,8
16494,297,1,826.5299999999999,1,2,3,6
16495,3,3,648.26,4,3,2,9
16496,9,3,1599.52,4,3,4,11
16497,50,6,2965.69,2,4,4,10
16498,161,2,100.97000000000001,1,2,1,4
16500,5,6,400.86,4,4,2,10
16503,107,3,943.84,2,3,3,8
16504,25,1,465.88000000000005,3,2,2,7
16505,32,1,777.6,3,2,3,8
16506,20,2,90.30000000000001,3,2,1,6
16509,297,1,363.70000000000005,1,2,2,5
16511,22,3,916.33,3,3,3,9
16513,5,4,874.5899999999999,4,3,3,10
16515,52,5,1624.14,2,4,4,10
16516,30,1,101.7,3,2,1,6
16517,277,1,162.70000000000005,1,2,1,4
16518,61,2,484.32000000000005,2,2,2,6
16519,25,1,109.28,3,2,1,6
16520,186,2,720.81,1,2,3,6
16523,2,21,9418.470000000001,4,4,4,12
16525,2,24,12225.010000000002,4,4,4,12
16526,172,1,290.35999999999996,1,2,1,4
16527,81,1,228.06000000000003,2,2,1,5
16528,4,1,244.41000000000003,4,2,1,7
16529,190,1,455.25,1,2,2,5
16531,22,6,1151.77,3,4,3,10
16532,18,3,6748.8,3,3,4,10
16533,19,3,1082.81,3,3,3,9
16535,5,1,593.75,4,2,2,8
16536,110,1,548.12,2,2,2,6
16539,3,2,641.5600000000001,4,2,2,8
16542,54,1,119.62,2,2,1,5
16545,165,1,339.3,1,2,2,5
16546,291,1,487.75,1,2,2,5
16549,10,10,4034.9,4,4,4,12
16550,109,4,1744.31,2,3,4,9
16551,96,3,922.12,2,3,3,8
16552,243,1,284.44,1,2,1,4
16553,163,10,4110.38,1,4,4,9
16554,42,3,837.0999999999999,3,3,3,9
16555,35,2,285.89,3,2,1,6
16556,67,6,3002.94,2,4,4,10
16557,24,2,281.84999999999997,3,2,1,6
16558,1,18,7457.9400000000005,4,4,4,12
16560,27,1,509.22999999999996,3,2,2,7
16561,6,2,511.12,4,2,2,8
16563,54,1,1077.74,2,2,3,7
16566,15,5,614.6600000000001,4,4,2,10
16567,194,2,865.6,1,2,3,6
16569,3,1,124.2,4,2,1,7
16570,15,10,3738.4,4,4,4,12
16571,27,3,1421.69,3,3,3,9
16572,127,3,1009.6,2,3,3,8
16573,85,2,663.61,2,2,3,7
16574,71,1,451.43999999999994,2,2,2,6
16581,183,1,105.84,1,2,1,4
16582,113,1,313.61999999999995,2,2,2,6
16584,80,2,936.0799999999998,2,2,3,7
16586,249,1,463.95,1,2,2,5
16587,232,1,225.14999999999995,1,2,1,4
16589,71,3,459.24,2,3,2,7
16591,69,1,213.5,2,2,1,5
16592,4,16,4113.68,4,4,4,12
16593,51,3,330.03000000000003,2,3,2,7
16594,75,1,181.09,2,2,1,5
16595,61,1,360.15999999999997,2,2,2,6
16596,16,1,129.5,4,2,1,7
16597,4,1,90.04000000000002,4,2,1,7
16598,286,1,145.05,1,2,1,4
16600,4,6,813.5199999999999,4,4,3,11
16601,41,1,241.52999999999997,3,2,1,6
16602,36,1,528.0799999999999,3,2,2,7
16603,75,2,482.47,2,2,2,6
16607,18,12,2692.89,3,4,4,11
16609,15,7,5493.46,4,4,4,12
16610,219,1,75.66,1,2,1,4
16611,186,1,129.49,1,2,1,4
16612,33,4,1187.6599999999999,3,3,3,9
16613,70,1,618.5900000000001,2,2,2,6
16614,183,1,506.19,1,2,2,5
16616,15,2,500.42,4,2,2,8
16617,236,1,151.85000000000002,1,2,1,4
16618,31,5,2647.5899999999997,3,4,4,11
16619,264,1,226.21,1,2,1,4
16620,4,2,178.96,4,2,1,7
16621,52,4,813.4800000000001,2,3,3,8
16623,246,1,129.45,1,2,1,4
16624,81,2,810.5699999999999,2,2,3,7
16625,275,1,333.08,1,2,2,5
16626,1,17,4413.1,4,4,4,12
16627,79,1,322.80000000000007,2,2,2,6
16628,30,5,2188.05,3,4,4,11
16629,74,2,408.63,2,2,2,6
16633,17,6,2883.1000000000004,4,4,4,12
16634,223,1,53.1,1,2,1,4
16637,32,4,1154.4700000000003,3,3,3,9
16638,23,8,1609.92,3,4,4,11
16639,31,3,1257.51,3,3,3,9
16641,106,1,231.10000000000002,2,2,1,5
16642,5,2,688.33,4,2,3,9
16643,246,1,487.51,1,2,2,5
16644,178,2,833.78,1,2,3,6
16647,170,2,214.06,1,2,1,4
16648,43,1,290.65999999999997,3,2,1,6
16650,72,1,518.4200000000001,2,2,2,6
16652,59,7,6773.97,2,4,4,10
16653,16,2,1212.6600000000003,4,2,3,9
16654,141,3,373.87,1,3,2,6
16655,18,6,3789.52,3,4,4,11
16656,22,14,8197.04,3,4,4,11
16657,10,4,874.43,4,3,3,10
16659,189,1,39.12,1,2,1,4
16660,16,4,1267.6499999999999,4,3,3,10
16666,19,1,118.97999999999999,3,2,1,6
16667,68,2,567.18,2,2,2,6
16668,15,6,306.71999999999997,4,4,2,10
16669,24,2,1344.48,3,2,3,8
16670,17,10,3692.2900000000004,4,4,4,12
16671,28,3,1692.27,3,3,4,10
16672,2,20,8134.94,4,4,4,12
16674,55,2,304.24,2,2,2,6
16676,34,4,1592.12,3,3,4,10
16678,3,12,3109.99,4,4,4,12
16680,43,1,183.7,3,2,1,6
16681,73,6,1770.3400000000001,2,4,4,10
16682,5,5,1027.9999999999998,4,4,3,11
16684,4,24,63540.16,4,4,4,12
16685,61,2,324.24,2,2,2,6
16686,47,6,2608.75,3,4,4,11
16688,1,4,1260.86,4,3,3,10
16689,76,2,422.59999999999997,2,2,2,6
16690,72,2,225.57999999999996,2,2,1,5
16692,256,2,1126.0,1,2,3,6
16693,69,2,477.85999999999996,2,2,2,6
16696,135,4,657.9000000000001,1,3,3,7
16697,241,1,112.75000000000001,1,2,1,4
16698,227,2,1998.0,1,2,4,7
16700,9,12,4739.610000000001,4,4,4,12
16701,9,12,4921.540000000001,4,4,4,12
16705,1,18,12903.27,4,4,4,12
16706,37,3,531.3499999999999,3,3,2,8
16708,46,1,656.6300000000001,3,2,3,8
16709,85,5,3029.8700000000003,2,4,4,10
16710,19,8,1948.07,3,4,4,11
16711,3,4,1436.8300000000002,4,3,3,10
16712,9,11,3603.66,4,4,4,12
16713,19,13,6152.24,3,4,4,11
16714,219,3,1129.06,1,3,3,7
16715,78,1,301.71999999999997,2,2,2,6
16716,267,2,901.2,1,2,3,6
16717,24,5,3535.83,3,4,4,11
16719,15,6,1339.4899999999998,4,4,3,11
16720,26,1,152.95,3,2,1,6
16721,262,1,292.46999999999997,1,2,1,4
16722,17,11,3931.29,4,4,4,12
16723,91,2,576.4,2,2,2,6
16725,302,4,437.82000000000005,1,3,2,6
16726,26,4,1229.17,3,3,3,9
16728,46,4,1048.28,3,3,3,9
16729,38,21,7202.01,3,4,4,11
16730,52,3,743.11,2,3,3,8
16732,32,1,603.7499999999999,3,2,2,7
16734,52,3,646.76,2,3,2,7
16735,79,5,2247.4100000000003,2,4,4,10
16737,53,1,417.59999999999997,2,2,2,6
16738,298,1,3.75,1,2,1,4
16739,177,1,323.00000000000006,1,2,2,5
16743,29,6,1782.85,3,4,4,11
16744,11,7,1291.9099999999999,4,4,3,11
16745,87,17,7180.7,2,4,4,10
16746,5,17,6368.470000000001,4,4,4,12
16747,38,2,836.06,3,2,3,8
16748,18,5,1515.8999999999999,3,4,3,10
16750,45,5,623.9300000000001,3,4,2,9
16751,31,1,1764.7199999999998,3,2,4,9
16753,58,1,223.92,2,2,1,5
16755,114,3,1475.4299999999998,2,3,3,8
16756,215,1,239.40000000000003,1,2,1,4
16757,319,1,106.83,1,2,1,4
16758,65,1,369.34000000000003,2,2,2,6
16759,8,3,789.79,4,3,3,10
16761,97,1,316.62,2,2,2,6
16762,20,3,1207.24,3,3,3,9
16763,199,1,611.8500000000001,1,2,2,5
16764,4,13,2790.9500000000003,4,4,4,12
16765,294,1,34.0,1,2,1,4
16766,273,2,1145.5999999999997,1,2,3,6
16767,31,11,5575.5599999999995,3,4,4,11
16768,48,3,478.0899999999999,2,3,2,7
16769,260,1,361.5399999999999,1,2,2,5
16770,58,3,494.9,2,3,2,7
16771,33,5,2230.61,3,4,4,11
16773,57,1,171.59,2,2,1,5
16774,68,4,661.52,2,3,3,8
16775,10,10,1459.6100000000001,4,4,3,11
16776,60,1,371.54,2,2,2,6
16777,80,2,222.62,2,2,1,5
16778,74,2,245.94,2,2,1,5
16779,2,20,9923.890000000001,4,4,4,12
16780,100,2,422.24,2,2,2,6
16782,10,11,1701.91,4,4,4,12
16784,20,1,107.6,3,2,1,6
16788,123,2,592.74,2,2,2,6
16789,8,1,80.8,4,2,1,7
16790,4,6,1545.6200000000001,4,4,3,11
16791,29,7,1693.03,3,4,4,11
16792,282,2,110.38000000000001,1,2,1,4
16793,57,1,243.84,2,2,1,5
16794,1,10,1194.48,4,4,3,11
16796,89,1,305.61999999999995,2,2,2,6
16800,11,1,1162.65,4,2,3,9
16801,163,4,1594.23,1,3,4,8
16803,65,1,332.3,2,2,2,6
16804,23,3,536.99,3,3,2,8
16805,174,1,245.82,1,2,1,4
16806,103,4,736.2100000000002,2,3,3,8
16807,143,3,1121.59,1,3,3,7
16808,99,2,288.42,2,2,1,5
16809,23,5,914.69,3,4,3,10
16810,192,1,309.53999999999996,1,2,2,5
16811,5,2,547.0699999999999,4,2,2,8
16813,8,10,1652.18,4,4,4,12
16814,14,20,6133.51,4,4,4,12
16816,103,3,341.28000000000003,2,3,2,7
16817,3,7,1237.4500000000003,4,4,3,11
16818,11,11,3349.57,4,4,4,12
16820,96,1,497.61,2,2,2,6
16823,227,1,358.37999999999994,1,2,2,5
16824,16,2,460.64,4,2,2,8
16825,39,2,775.1800000000001,3,2,3,8
16826,51,1,341.70000000000005,2,2,2,6
16828,112,1,113.5,2,2,1,5
16829,157,1,197.22,1,2,1,4
16830,39,1,325.90999999999997,3,2,2,7
16832,184,3,199.15,1,3,1,5
16833,1,4,1106.53,4,3,3,10
16834,228,1,413.46000000000004,1,2,2,5
16835,128,1,99.1,1,2,1,4
16836,40,2,251.87,3,2,1,6
16837,31,11,3170.9799999999996,3,4,4,11
16838,197,2,588.85,1,2,2,5
16839,9,33,16042.109999999999,4,4,4,12
16841,37,6,1869.82,3,4,4,11
16842,101,3,1264.19,2,3,3,8
16843,43,16,10196.570000000002,3,4,4,11
16846,50,1,214.32000000000002,2,2,1,5
16847,43,1,193.44,3,2,1,6
16848,53,1,281.42,2,2,1,5
16849,187,1,124.57,1,2,1,4
16850,334,1,332.41,1,2,2,5
16851,4,3,342.45000000000005,4,3,2,9
16852,10,2,144.91,4,2,1,7
16855,24,2,328.40000000000003,3,2,2,7
16856,15,1,35.400000000000006,4,2,1,7
16859,145,2,747.8100000000001,1,2,3,6
16861,60,2,173.76,2,2,1,5
16863,31,1,338.55,3,2,2,7
16866,141,3,207.73999999999998,1,3,1,5
16869,23,4,817.1200000000001,3,3,3,9
16871,22,6,2812.34,3,4,4,11
16872,77,3,680.02,2,3,3,8
16873,5,5,4965.98,4,4,4,12
16875,67,5,2095.53,2,4,4,10
16877,12,6,846.62,4,4,3,11
16878,84,1,13.3,2,2,1,5
16880,31,7,1491.43,3,4,3,10
16881,67,1,432.0,2,2,2,6
16882,67,3,705.12,2,3,3,8
16883,187,1,144.44999999999996,1,2,1,4
16884,38,2,429.84000000000003,3,2,2,7
16885,15,2,272.46,4,2,1,7
16887,35,1,192.33,3,2,1,6
16889,195,3,1578.67,1,3,3,7
16891,2,4,525.1700000000001,4,3,2,9
16892,1,5,518.19,4,4,2,10
16895,65,1,202.26999999999998,2,2,1,5
16897,299,2,289.78,1,2,1,4
16898,26,2,388.95,3,2,2,7
16899,8,5,1100.51,4,4,3,11
16900,17,3,882.16,3,3,3,9
16902,116,1,1706.88,2,2,4,8
16903,29,1,363.2,3,2,2,7
16904,4,14,3311.25,4,4,4,12
16905,5,6,2783.2,4,4,4,12
16906,82,4,559.5900000000003,2,3,2,7
16907,29,4,748.84,3,3,3,9
16909,72,1,379.14,2,2,2,6
16910,4,8,1508.9599999999998,4,4,3,11
16912,29,11,2555.5800000000004,3,4,4,11
16913,290,1,113.44,1,2,1,4
16914,36,1,183.75999999999996,3,2,1,6
16915,9,6,621.6800000000001,4,4,2,10
16916,24,1,365.9800000000001,3,2,2,7
16917,277,1,391.52000000000004,1,2,2,5
16918,50,6,1068.8200000000002,2,4,3,9
16919,156,9,2052.2400000000002,1,4,4,9
16921,61,1,154.18,2,2,1,5
16923,12,18,6518.58,4,4,4,12
16924,21,3,829.8900000000001,3,3,3,9
16927,116,2,324.95,2,3,2,7
16928,80,16,2690.5,2,4,4,10
16929,4,7,1295.3899999999999,4,4,3,11
16930,26,3,378.89,3,3,2,8
16931,5,19,4190.21,4,4,4,12
16932,53,1,150.23,2,2,1,5
16933,1,2,563.23,4,3,2,9
16934,55,2,931.0300000000002,2,3,3,8
16936,26,1,261.90000000000003,3,2,1,6
16938,9,4,2711.6800000000003,4,3,4,11
16940,52,3,3049.88,2,3,4,9
16942,13,9,1904.99,4,4,4,12
16943,212,3,816.7299999999999,1,3,3,7
16945,22,18,4065.650000000001,3,4,4,11
16947,236,1,406.48,1,2,2,5
16948,139,3,435.02000000000004,1,3,2,6
16949,4,6,1286.2700000000002,4,4,3,11
16950,57,2,1006.56,2,3,3,8
16951,135,3,1277.7500000000002,1,3,3,7
16952,109,2,167.60999999999999,2,3,1,6
16953,30,1,20.8,3,2,1,6
16954,1,8,1738.2800000000002,4,4,4,12
16955,185,2,329.57,1,3,2,6
16956,18,1,308.74,3,2,2,7
16957,239,2,416.64,1,3,2,6
16959,87,1,117.35000000000001,2,2,1,5
16960,39,3,505.1,3,3,2,8
16961,116,1,234.17000000000002,2,2,1,5
16963,187,1,110.55000000000001,1,2,1,4
16965,227,1,192.07,1,2,1,4
16966,8,7,2154.9700000000003,4,4,4,12
16967,189,1,319.02,1,2,2,5
16968,4,2,439.43,4,3,2,9
16969,39,3,650.4100000000001,3,3,2,8
16971,38,1,357.21,3,2,2,7
16976,267,1,251.51999999999998,1,2,1,4
16978,78,1,344.3299999999999,2,2,2,6
16979,4,6,1852.0,4,4,4,12
16980,255,2,1028.46,1,3,3,7
16982,61,1,384.06,2,2,2,6
16983,13,6,1742.38,4,4,4,12
16984,88,2,4459.52,2,3,4,9
16985,17,9,4530.799999999999,3,4,4,11
16986,30,2,1873.2,3,3,4,10
16987,3,7,1616.8000000000002,4,4,4,12
16988,5,1,126.12,4,2,1,7
16989,7,6,1133.25,4,4,3,11
16990,219,1,179.0,1,2,1,4
16992,11,5,1614.3099999999997,4,4,4,12
16996,30,4,1329.42,3,3,3,9
16997,288,3,702.0,1,3,3,7
16998,150,4,295.0,1,3,1,5
16999,23,2,484.82,3,3,2,8
17001,1,10,3591.61,4,4,4,12
17002,86,3,1493.7300000000002,2,3,3,8
17004,46,2,1312.14,3,3,3,9
17006,5,4,781.78,4,3,3,10
17007,51,4,682.81,2,3,3,8
17010,18,1,195.36,3,2,1,6
17011,30,1,270.9,3,2,1,6
17014,8,3,583.4300000000001,4,3,2,9
17015,29,3,1838.6100000000001,3,3,4,10
17017,3,15,6336.620000000001,4,4,4,12
17018,41,2,920.1,3,3,3,9
17019,11,3,899.26,4,3,3,10
17022,31,1,71.0,3,2,1,6
17024,45,3,95.85,3,3,1,7
17025,61,1,196.8,2,2,1,5
17026,185,1,121.67999999999999,1,2,1,4
17027,79,6,877.56,2,4,3,9
17029,111,2,716.0,2,3,3,8
17030,64,1,146.87000000000003,2,2,1,5
17031,12,2,380.35,4,3,2,9
17033,86,2,722.3399999999999,2,3,3,8
17034,16,3,745.5200000000001,4,3,3,10
17035,246,2,433.53,1,3,2,6
17037,88,1,1267.32,2,2,3,7
17038,30,1,112.40000000000002,3,2,1,6
17040,138,1,449.72999999999996,1,2,2,5
17041,27,2,766.9899999999999,3,3,3,9
17042,3,5,1036.5800000000002,4,4,3,11
17043,32,4,1735.18,3,3,4,10
17044,25,1,948.48,3,2,3,8
17045,113,3,339.43999999999994,2,3,2,7
17046,157,1,642.0199999999999,1,2,2,5
17047,85,3,1100.8999999999999,2,3,3,8
17048,118,3,925.35,2,3,3,8
17049,3,9,5655.030000000001,4,4,4,12
17050,96,6,3185.64,2,4,4,10
17051,194,1,240.89,1,2,1,4
17052,28,1,399.0899999999999,3,2,2,7
17053,131,1,498.47999999999996,1,2,2,5
17054,28,5,1356.3300000000002,3,4,3,10
17058,82,3,1179.8899999999999,2,3,3,8
17059,30,4,2358.03,3,3,4,10
17060,266,1,234.24,1,2,1,4
17061,74,11,5232.23,2,4,4,10
17062,314,1,102.63999999999999,1,2,1,4
17063,21,7,1461.14,3,4,3,10
17064,59,3,855.4499999999999,2,3,3,8
17068,12,19,4254.6900000000005,4,4,4,12
17069,28,7,2126.5,3,4,4,11
17070,114,1,304.23999999999995,2,2,2,6
17071,28,9,2429.03,3,4,4,11
17073,18,4,1444.8400000000001,3,3,3,9
17075,18,4,834.1199999999999,3,3,3,9
17076,36,2,689.58,3,3,3,9
17078,36,2,375.86,3,3,2,8
17079,78,1,118.80000000000001,2,2,1,5
17080,22,2,287.62,3,3,1,7
17081,25,2,288.91,3,3,1,7
17082,33,2,2003.85,3,3,4,10
17083,109,3,1405.78,2,3,3,8
17084,35,2,2747.99,3,3,4,10
17085,123,3,826.2099999999999,2,3,3,8
17086,7,6,2050.08,4,4,4,12
17088,28,4,1991.0100000000002,3,3,4,10
17090,4,6,1913.4500000000003,4,4,4,12
17091,3,8,3534.3100000000004,4,4,4,12
17092,50,4,1774.0300000000002,2,3,4,9
17094,322,1,301.99999999999994,1,2,2,5
17095,23,3,1324.1599999999999,3,3,3,9
17096,15,4,1022.1299999999999,4,3,3,10
17097,2,7,779.6999999999999,4,4,3,11
17100,18,2,971.74,3,3,3,9
17101,10,4,1621.73,4,3,4,11
17102,262,1,25.5,1,2,1,4
17105,159,2,665.7799999999999,1,3,3,7
17107,33,6,10797.48,3,4,4,11
17109,29,6,881.29,3,4,3,10
17110,165,1,163.3,1,2,1,4
17111,47,1,231.60999999999999,3,2,1,6
17114,6,8,801.12,4,4,3,11
17115,8,3,837.4999999999997,4,3,3,10
17117,288,1,116.19999999999999,1,2,1,4
17118,318,1,157.02,1,2,1,4
17119,3,2,606.91,4,3,2,9
17120,233,1,307.46000000000004,1,2,2,5
17122,119,1,138.32,2,2,1,5
17123,162,1,345.29999999999995,1,2,2,5
17124,185,1,294.24,1,2,1,4
17125,50,1,230.5,2,2,1,5
17126,152,4,787.5,1,3,3,7
17128,335,1,157.08999999999997,1,2,1,4
17131,5,5,2463.17,4,4,4,12
17133,16,7,4892.240000000001,4,4,4,12
17134,107,2,413.2,2,3,2,7
17135,16,6,924.1499999999999,4,4,3,11
17138,276,1,380.5,1,2,2,5
17139,16,12,10650.77,4,4,4,12
17140,247,1,454.12,1,2,2,5
17142,239,1,578.9999999999999,1,2,2,5
17144,1,2,984.5699999999999,4,3,3,10
17146,106,2,451.53000000000003,2,3,2,7
17147,23,4,1714.59,3,3,4,10
17148,52,1,124.88,2,2,1,5
17152,195,3,1689.5,1,3,4,8
17153,24,1,213.77999999999997,3,2,1,6
17154,75,1,329.34,2,2,2,6
17155,18,2,251.69999999999993,3,3,1,7
17157,8,2,319.0,4,3,2,9
17158,32,2,853.1800000000001,3,3,3,9
17159,22,3,1538.88,3,3,3,9
17160,31,6,3518.0299999999997,3,4,4,11
17162,29,10,1715.46,3,4,4,11
17163,22,2,293.1,3,3,1,7
17164,33,7,2467.35,3,4,4,11
17165,284,1,158.68,1,2,1,4
17166,39,2,206.33999999999997,3,3,1,7
17169,58,2,835.7800000000002,2,3,3,8
17171,289,1,224.91,1,2,1,4
17172,79,1,317.76,2,2,2,6
17173,5,8,3766.5999999999995,4,4,4,12
17174,218,1,59.9,1,2,1,4
17175,44,4,1443.69,3,3,3,9
17176,202,1,306.13,1,2,2,5
17179,178,2,468.78999999999996,1,3,2,6
17180,56,4,783.9700000000003,2,3,3,8
17181,57,1,84.39999999999999,2,2,1,5
17183,8,6,3347.31,4,4,4,12
17186,47,2,144.0,3,3,1,7
17187,227,1,203.95,1,2,1,4
17188,11,6,1960.5900000000004,4,4,4,12
17189,106,1,157.18,2,2,1,5
17190,59,2,444.74,2,3,2,7
17191,28,4,1583.57,3,3,4,10
17193,36,7,1699.3000000000002,3,4,4,11
17197,30,1,1013.01,3,2,3,8
17198,24,1,170.56,3,2,1,6
17201,54,1,289.78000000000003,2,2,1,5
17203,36,6,3560.08,3,4,4,11
17204,175,4,1564.56,1,3,3,7
17205,54,1,384.08,2,2,2,6
17206,53,1,204.24,2,2,1,5
17211,27,5,1537.51,3,4,3,10
17212,253,1,226.85,1,2,1,4
17213,40,5,2165.3799999999997,3,4,4,11
17214,60,5,888.0699999999998,2,4,3,9
17217,234,1,113.49999999999999,1,2,1,4
17218,4,7,1350.69,4,4,3,11
17219,32,1,114.23,3,2,1,6
17220,24,13,2870.05,3,4,4,11
17221,7,2,334.48,4,3,2,9
17222,65,1,328.65,2,2,2,6
17223,310,1,124.04999999999998,1,2,1,4
17226,309,1,393.48999999999995,1,2,2,5
17227,19,5,797.07,3,4,3,10
17228,16,6,1550.14,4,4,3,11
17229,96,2,318.76000000000005,2,3,2,7
17230,264,2,878.4,1,3,3,7
17231,12,9,2892.71,4,4,4,12
17232,3,2,417.77,4,3,2,9
17233,35,1,190.88,3,2,1,6
17234,183,1,149.89,1,2,1,4
17235,25,1,208.15999999999997,3,2,1,6
17236,13,5,789.85,4,4,3,11
17237,11,2,314.69,4,3,2,9
17238,3,15,3349.01,4,4,4,12
17239,313,1,382.50000000000006,1,2,2,5
17242,108,2,1135.04,2,3,3,8
17243,1,23,7703.500000000001,4,4,4,12
17244,53,1,954.9,2,2,3,7
17245,205,1,171.45,1,2,1,4
17247,15,1,280.09000000000003,4,2,1,7
17248,120,1,318.65000000000003,2,2,2,6
17250,4,2,381.97,4,3,2,9
17252,117,2,348.90999999999997,2,3,2,7
17253,18,1,178.26,3,2,1,6
17254,5,2,271.19,4,3,1,8
17255,41,2,291.47999999999996,3,3,1,7
17256,107,2,240.0,2,3,1,6
17259,148,1,213.28,1,2,1,4
17262,52,4,984.5,2,3,3,8
17263,208,1,63.440000000000005,1,2,1,4
17265,139,2,550.0100000000001,1,3,2,6
17266,2,3,296.58,4,3,1,8
17267,127,2,317.2,2,3,2,7
17268,108,4,763.64,2,3,3,8
17272,42,4,2148.6300000000006,3,3,4,10
17274,35,1,107.82,3,2,1,6
17277,228,2,1065.3500000000001,1,3,3,7
17278,241,1,246.04000000000002,1,2,1,4
17279,58,1,187.82999999999998,2,2,1,5
17282,130,3,1685.46,1,3,4,8
17284,60,6,1647.48,2,4,4,10
17286,22,1,151.37,3,2,1,6
17287,26,5,826.36,3,4,3,10
17288,9,6,1284.07,4,4,3,11
17289,32,3,931.02,3,3,3,9
17290,4,2,513.01,4,3,2,9
17291,308,1,550.8000000000001,1,2,2,5
17293,8,8,1507.9199999999998,4,4,3,11
17295,29,3,547.0,3,3,2,8
17297,17,1,128.18,3,2,1,6
17298,101,2,498.42,2,3,2,7
17299,12,4,656.61,4,3,3,10
17301,21,1,163.24,3,2,1,6
17302,15,5,1135.63,4,4,3,11
17306,11,18,8307.31,4,4,4,12
17309,95,1,82.75,2,2,1,5
17311,78,2,1384.85,2,3,3,8
17312,139,3,644.3,1,3,2,6
17313,31,1,2328.84,3,2,4,9
17314,25,8,2527.92,3,4,4,11
17315,2,35,6132.23,4,4,4,12
17317,46,3,2600.34,3,3,4,10
17320,100,2,749.7,2,3,3,8
17321,8,2,657.16,4,3,3,10
17323,15,7,903.1200000000001,4,4,3,11
17324,18,3,859.43,3,3,3,9
17325,280,1,96.8,1,2,1,4
17329,14,2,523.11,4,3,2,9
17330,23,2,363.9,3,3,2,8
17331,124,1,175.2,2,2,1,5
17333,86,1,494.25,2,2,2,6
17334,302,2,307.02000000000004,1,3,2,6
17337,151,4,1979.6100000000001,1,3,4,8
17338,17,7,5717.15,3,4,4,11
17339,94,1,183.36,2,2,1,5
17340,30,9,7992.900000000001,3,4,4,11
17341,157,2,265.67999999999995,1,3,1,5
17344,46,1,157.61999999999998,3,2,1,6
17345,15,4,519.69,4,3,2,9
17346,4,13,2387.54,4,4,4,12
17347,86,1,228.96,2,2,1,5
17348,15,5,1156.6,4,4,3,11
17349,179,1,98.25,1,2,1,4
17350,8,4,1281.3200000000004,4,3,3,10
17351,36,3,587.15,3,3,2,8
17353,129,2,1740.0,1,3,4,8
17354,51,1,1393.06,2,2,3,7
17356,312,1,178.21999999999997,1,2,1,4
17357,24,2,384.39,3,3,2,8
17358,303,1,119.15,1,2,1,4
17359,11,1,127.85999999999999,4,2,1,7
17360,17,3,568.2400000000001,3,3,2,8
17361,49,3,488.20000000000005,2,3,2,7
17362,239,2,312.22999999999996,1,3,2,6
17364,1,11,4462.68,4,4,4,12
17365,13,8,4762.32,4,4,4,12
17367,238,1,167.54999999999998,1,2,1,4
17368,23,8,1878.8700000000001,3,4,4,11
17370,73,4,446.17999999999995,2,3,2,7
17371,17,2,326.25999999999993,3,3,2,8
17372,41,6,970.6500000000001,3,4,3,10
17373,40,4,646.9200000000001,3,3,2,8
17374,219,2,495.7699999999999,1,3,2,6
17375,199,2,290.39,1,3,1,5
17376,71,2,203.2,2,3,1,6
17377,24,17,3273.2400000000002,3,4,4,11
17379,11,1,389.72,4,2,2,8
17381,9,26,16671.89,4,4,4,12
17382,65,1,65.4,2,2,1,5
17383,4,1,193.39,4,2,1,7
17384,19,2,336.4,3,3,2,8
17385,15,1,256.11,4,2,1,7
17386,8,6,2686.4200000000005,4,4,4,12
17387,20,2,746.81,3,3,3,9
17388,78,4,1259.5600000000002,2,3,3,8
17389,1,34,31833.68,4,4,4,12
17391,164,2,508.8,1,3,2,6
17392,307,1,145.5,1,2,1,4
17394,219,1,203.86999999999995,1,2,1,4
17396,39,6,6915.3,3,4,4,11
17397,22,2,681.41,3,3,3,9
17398,115,3,653.38,2,3,2,7
17400,126,4,1673.67,2,3,4,9
17402,5,10,2138.8799999999997,4,4,4,12
17403,36,1,263.92,3,2,1,6
17404,4,11,27947.52,4,4,4,12
17405,1,3,1031.41,4,3,3,10
17406,333,2,1482.32,1,3,3,7
17408,163,1,32.65,1,2,1,4
17409,185,2,771.8499999999999,1,3,3,7
17410,16,5,1214.72,4,4,3,11
17411,12,3,778.9399999999999,4,3,3,10
17412,3,5,810.3000000000002,4,4,3,11
17414,44,2,778.0,3,3,3,9
17415,80,1,507.8399999999999,2,2,2,6
17416,30,7,6893.42,3,4,4,11
17418,42,2,463.46,3,3,2,8
17419,11,10,3852.2999999999997,4,4,4,12
17420,50,2,467.98,2,3,2,7
17422,16,6,1979.3700000000001,4,4,4,12
17423,46,2,698.41,3,3,3,9
17425,19,2,759.1700000000001,3,3,3,9
17426,8,6,5037.26,4,4,4,12
17427,72,1,100.8,2,2,1,5
17428,1,26,16362.9,4,4,4,12
17429,128,3,524.9200000000001,1,3,2,6
17430,33,1,153.16,3,2,1,6
17431,313,1,403.3,1,2,2,5
17432,18,2,365.76,3,3,2,8
17433,88,1,303.15999999999997,2,2,2,6
17434,2,7,2373.8199999999997,4,4,4,12
17436,2,2,216.3,4,3,1,8
17438,254,1,388.45000000000005,1,2,2,5
17440,157,3,186.42,1,3,1,5
17442,37,6,2248.56,3,4,4,11
17443,220,1,534.24,1,2,2,5
17444,152,2,2389.1000000000004,1,3,4,8
17446,177,2,120.90000000000002,1,3,1,5
17447,40,2,541.53,3,3,2,8
17449,2,6,1831.95,4,4,4,12
17450,8,44,192361.95,4,4,4,12
17451,1,7,1721.4,4,4,4,12
17453,18,2,486.71999999999997,3,3,2,8
17454,192,3,351.68000000000006,1,3,2,6
17455,204,1,131.7,1,2,1,4
17457,127,5,1737.7,2,4,4,10
17458,15,1,316.49999999999994,4,2,2,8
17459,43,2,657.3,3,3,3,9
17460,94,4,552.13,2,3,2,7
17461,23,3,735.82,3,3,3,9
17462,60,2,675.6899999999999,2,3,3,8
17463,16,5,1875.86,4,4,4,12
17464,158,1,289.96000000000004,1,2,1,4
17466,10,2,763.28,4,3,3,10
17468,10,2,137.0,4,3,1,8
17469,16,5,1870.9700000000003,4,4,4,12
17470,45,4,946.6700000000001,3,3,3,9
17472,191,3,697.5400000000001,1,3,3,7
17475,79,1,194.36999999999995,2,2,1,5
17480,78,1,511.82,2,2,2,6
17481,4,4,1255.59,4,3,3,10
17483,65,3,414.04,2,3,2,7
17486,261,1,396.87,1,2,2,5
17489,59,2,376.63999999999993,2,3,2,7
17490,1,7,2092.32,4,4,4,12
17491,1,9,3231.4700000000003,4,4,4,12
17492,248,1,374.57,1,2,2,5
17495,8,2,497.56000000000006,4,3,2,9
17498,76,1,272.22,2,2,1,5
17499,290,1,622.88,1,2,2,5
17500,17,3,1138.0,3,3,3,9
17501,221,2,288.59999999999997,1,3,1,5
17502,9,4,689.0999999999999,4,3,3,10
17503,3,2,558.9599999999999,4,3,2,9
17504,206,9,2997.03,1,4,4,9
17505,162,2,1145.84,1,3,3,7
17506,76,1,302.20000000000005,2,2,2,6
17507,262,2,605.58,1,3,2,6
17508,281,1,387.31,1,2,2,5
17509,58,8,6083.639999999999,2,4,4,10
17510,25,1,308.48,3,2,2,7
17511,3,28,84351.3,4,4,4,12
17512,29,10,2924.99,3,4,4,11
17513,72,1,513.2,2,2,2,6
17514,128,1,208.65,1,2,1,4
17515,31,4,639.02,3,3,2,8
17516,15,5,764.8799999999999,4,4,3,11
17517,309,1,153.94,1,2,1,4
17519,17,5,1508.7199999999998,3,4,3,10
17520,54,1,546.81,2,2,2,6
17521,30,3,723.21,3,3,3,9
17522,2,5,1066.15,4,4,3,11
17523,11,4,652.74,4,3,2,9
17526,5,2,957.3,4,3,3,10
17527,54,4,939.37,2,3,3,8
17528,1,8,3628.5,4,4,4,12
17530,1,9,2061.89,4,4,4,12
17531,190,1,296.7,1,2,1,4
17534,54,1,223.36,2,2,1,5
17535,280,1,164.39999999999998,1,2,1,4
17536,177,1,76.5,1,2,1,4
17537,30,2,887.67,3,3,3,9
17538,26,1,98.42,3,2,1,6
17540,25,2,578.9,3,3,2,8
17542,270,1,170.75,1,2,1,4
17545,43,3,642.3199999999999,3,3,2,8
17548,234,1,103.3,1,2,1,4
17549,24,2,148.86,3,3,1,7
17550,197,3,267.1600000000001,1,3,1,5
17552,60,2,631.89,2,3,2,7
17553,130,1,1487.6,1,2,3,6
17554,1,5,1952.4499999999998,4,4,4,12
17555,20,2,480.31,3,3,2,8
17556,206,1,157.9,1,2,1,4
17557,14,3,541.4599999999999,4,3,2,9
17560,95,4,854.95,2,3,3,8
17561,19,1,165.11999999999998,3,2,1,6
17562,14,7,1122.3799999999999,4,4,3,11
17564,24,3,454.01,3,3,2,8
17566,8,2,869.77,4,3,3,10
17567,7,7,3813.5299999999997,4,4,4,12
17569,332,1,344.13999999999993,1,2,2,5
17571,50,4,1424.42,2,3,3,8
17572,71,3,155.95,2,3,1,6
17573,29,3,380.59999999999997,3,3,2,8
17574,243,1,185.64999999999998,1,2,1,4
17576,8,17,3267.83,4,4,4,12
17578,218,1,143.45999999999998,1,2,1,4
17579,5,3,448.8999999999999,4,3,2,9
17580,253,2,165.92000000000002,1,3,1,5
17581,1,23,10238.46,4,4,4,12
17582,236,1,175.27,1,2,1,4
17584,7,2,1242.3000000000002,4,3,3,10
17585,109,4,1116.68,2,4,3,9
17588,100,3,1240.2,2,3,3,8
17589,60,4,2402.9199999999996,2,4,4,10
17590,2,3,1466.7700000000002,4,3,3,10
17591,73,6,1819.3700000000003,2,4,4,10
17593,4,4,3260.96,4,4,4,12
17594,85,2,993.1800000000001,2,3,3,8
17595,12,2,386.69000000000005,4,3,2,9
17596,23,6,2415.7200000000003,3,4,4,11
17597,214,1,2044.37,1,2,4,7
17600,18,1,161.67000000000002,3,2,1,6
17601,239,1,116.00999999999999,1,2,1,4
17602,2,6,5054.42,4,4,4,12
17603,78,1,394.71999999999997,2,2,2,6
17604,217,2,309.35999999999996,1,3,2,6
17608,33,2,191.99,3,3,1,7
17609,41,5,1098.2799999999997,3,4,3,10
17611,7,14,3716.93,4,4,4,12
17612,53,6,2048.45,2,4,4,10
17613,23,14,4544.55,3,4,4,11
17614,57,1,386.32,2,2,2,6
17615,130,3,329.6000000000001,1,3,2,6
17616,174,2,244.79999999999998,1,3,1,5
17618,6,2,651.3000000000001,4,3,2,9
17619,312,1,214.36999999999998,1,2,1,4
17620,60,1,81.44,2,2,1,5
17621,21,2,1140.5,3,3,3,9
17623,33,1,527.0500000000001,3,2,2,7
17624,15,2,843.48,4,3,3,10
17625,18,4,2020.4,3,4,4,11
17628,81,1,75.75000000000001,2,2,1,5
17629,6,7,1575.4700000000003,4,4,3,11
17630,170,2,503.59999999999997,1,3,2,6
17631,2,3,528.3300000000002,4,3,2,9
17633,31,4,1324.8400000000001,3,4,3,10
17634,36,9,2358.59,3,4,4,11
17636,19,1,285.55999999999995,3,2,1,6
17637,31,2,547.0600000000001,3,3,2,8
17639,276,1,108.5,1,2,1,4
17640,87,1,621.6600000000001,2,2,2,6
17642,120,2,712.29,2,3,3,8
17644,1,11,2895.64,4,4,4,12
17646,219,2,757.39,1,3,3,7
17647,65,1,133.06,2,2,1,5
17648,61,4,1797.5,2,4,4,10
17649,138,1,868.49,1,2,3,6
17650,21,1,166.07999999999998,3,2,1,6
17651,12,10,3945.0,4,4,4,12
17652,25,12,4867.72,3,4,4,11
17653,37,4,1207.56,3,4,3,10
17654,277,1,117.55000000000001,1,2,1,4
17655,11,6,1962.8400000000001,4,4,4,12
17656,73,5,1674.6900000000003,2,4,4,10
17658,26,2,595.42,3,3,2,8
17659,17,10,2639.51,3,4,4,11
17660,141,1,178.75000000000003,1,2,1,4
17663,26,7,1802.9100000000003,3,4,4,11
17664,19,2,604.64,3,3,2,8
17666,4,2,728.1599999999999,4,3,3,10
17667,66,5,2055.51,2,4,4,10
17668,1,2,347.75,4,3,2,9
17669,43,7,3406.72,3,4,4,11
17670,228,1,205.7,1,2,1,4
17671,16,3,1178.5300000000002,4,3,3,10
17672,50,2,3178.17,2,3,4,9
17673,2,6,1594.9699999999998,4,4,4,12
17674,74,1,250.38,2,2,1,5
17675,1,29,19355.160000000003,4,4,4,12
17676,4,5,1070.48,4,4,3,11
17677,2,26,14728.779999999999,4,4,4,12
17678,264,1,298.11,1,2,1,4
17679,53,2,1992.1100000000001,2,3,4,9
17680,24,1,184.39999999999998,3,2,1,6
17682,10,5,2082.83,4,4,4,12
17684,44,1,239.41,3,2,1,6
17685,17,5,2692.81,3,4,4,11
17686,7,7,5739.460000000001,4,4,4,12
17690,30,11,4038.9,3,4,4,11
17692,127,3,397.68,2,3,2,7
17693,137,1,200.46999999999997,1,2,1,4
17694,142,1,283.12,1,2,1,4
17695,132,2,765.3400000000001,1,3,3,7
17696,38,6,2110.11,3,4,4,11
17697,236,1,338.95000000000005,1,2,2,5
17698,261,1,154.95,1,2,1,4
17700,17,4,2534.64,3,4,4,11
17701,253,1,417.95000000000005,1,2,2,5
17702,30,4,1824.37,3,4,4,11
17703,35,3,798.74,3,3,3,9
17704,169,2,885.1899999999999,1,3,3,7
17705,3,9,1823.52,4,4,4,12
17706,4,14,10026.66,4,4,4,12
17707,185,2,152.39999999999998,1,3,1,5
17708,188,2,263.33,1,3,1,5
17709,170,1,137.45,1,2,1,4
17711,11,2,385.1,4,3,2,9
17712,45,1,522.91,3,2,2,7
17714,321,1,153.0,1,2,1,4
17715,201,1,326.4,1,2,2,5
17716,23,11,5655.99,3,4,4,11
17718,232,1,139.35,1,2,1,4
17719,38,15,5396.04,3,4,4,11
17720,26,3,1093.94,3,3,3,9
17722,96,3,1513.8999999999999,2,3,3,8
17723,127,6,3276.4,2,4,4,10
17724,71,3,1033.0,2,3,3,8
17725,16,11,3439.08,4,4,4,12
17727,15,1,1060.25,4,2,3,9
17728,4,3,2876.01,4,3,4,11
17730,3,13,5298.48,4,4,4,12
17731,79,4,1240.11,2,4,3,9
17733,39,2,692.1899999999999,3,3,3,9
17734,54,3,700.63,2,3,3,8
17735,2,18,12655.419999999998,4,4,4,12
17736,9,3,377.44,4,3,2,9
17737,9,2,168.24,4,3,1,8
17738,19,4,1879.05,3,4,4,11
17739,12,6,2431.29,4,4,4,12
17742,113,2,355.11,2,3,2,7
17744,4,5,1944.88,4,4,4,12
17746,240,1,110.25000000000001,1,2,1,4
17747,113,1,71.4,2,2,1,5
17749,178,2,674.52,1,3,3,7
17750,5,9,1694.1599999999999,4,4,4,12
17754,1,5,1664.6499999999999,4,4,4,12
17757,1,26,5023.64,4,4,4,12
17758,19,8,3408.2000000000003,3,4,4,11
17759,17,3,818.71,3,3,3,9
17760,22,1,115.05,3,2,1,6
17761,33,1,712.78,3,2,3,8
17763,263,1,15.0,1,2,1,4
17764,51,2,772.5500000000001,2,3,3,8
17765,159,3,367.63,1,3,2,6
17767,15,1,271.20000000000005,4,2,1,7
17768,8,3,2081.9,4,3,4,11
17769,13,10,3957.43,4,4,4,12
17770,199,5,1143.2699999999998,1,4,3,8
17771,57,2,245.33,2,3,1,6
17772,11,2,173.45,4,3,1,8
17774,97,4,1213.73,2,4,3,9
17775,255,1,56.4,1,2,1,4
17777,25,3,647.56,3,3,2,8
17779,21,3,650.32,3,3,2,8
17781,159,2,188.01999999999998,1,3,1,5
17783,72,2,283.4699999999999,2,3,1,6
17785,53,1,131.94,2,2,1,5
17786,85,2,266.8500000000001,2,3,1,6
17787,153,3,1081.26,1,3,3,7
17788,74,2,1112.95,2,3,3,8
17789,281,1,225.9,1,2,1,4
17790,27,9,1564.7500000000002,3,4,3,10
17791,30,1,106.1,3,2,1,6
17793,25,1,300.34,3,2,1,6
17795,180,2,342.82999999999987,1,3,2,6
17796,40,3,575.3500000000001,3,3,2,8
17797,22,3,780.4300000000002,3,3,3,9
17799,22,9,2815.69,3,4,4,11
17800,37,9,1186.2099999999998,3,4,3,10
17802,82,2,1184.84,2,3,3,8
17805,74,1,512.31,2,2,2,6
17806,11,1,546.04,4,2,2,8
17809,16,9,4160.410000000001,4,4,4,12
17811,4,39,7755.120000000001,4,4,4,12
17812,13,3,506.51,4,3,2,9
17813,14,5,1698.0700000000002,4,4,4,12
17816,37,3,20.35,3,3,1,7
17817,4,3,387.68,4,3,2,9
17819,72,5,2724.7499999999995,2,4,4,10
17824,51,1,298.4,2,2,1,5
17827,5,2,716.3700000000001,4,3,3,10
17828,23,4,1165.09,3,4,3,10
17829,299,1,889.24,1,2,3,6
17830,2,3,398.69999999999993,4,3,2,9
17831,33,1,35.400000000000006,3,2,1,6
17832,50,1,155.37000000000003,2,2,1,5
17835,3,3,342.23999999999995,4,3,2,9
17836,47,1,109.83,2,2,1,5
17837,42,8,1535.33,3,4,3,10
17838,27,3,1817.94,3,3,4,10
17839,42,1,318.15000000000003,3,2,2,7
17841,2,118,38027.869999999995,4,4,4,12
17843,303,1,197.73,1,2,1,4
17844,107,1,51.56,2,2,1,5
17848,81,8,803.9,2,4,3,9
17849,218,4,605.8000000000001,1,4,2,7
17852,12,2,114.34,4,3,1,8
17854,185,2,311.26,1,3,2,6
17856,2,4,1418.0300000000002,4,4,3,11
17857,4,20,23960.839999999997,4,4,4,12
17858,6,10,3598.8100000000004,4,4,4,12
17859,305,1,141.92000000000002,1,2,1,4
17861,3,8,2097.88,4,4,4,12
17862,324,1,330.9,1,2,2,5
17863,59,5,2775.28,2,4,4,10
17864,13,3,554.85,4,3,2,9
17865,31,18,9444.39,3,4,4,11
17866,143,1,329.65,1,2,2,5
17867,30,6,1157.8700000000001,3,4,3,10
17869,107,4,213.85999999999999,2,4,1,7
17870,2,11,1539.49,4,4,3,11
17871,205,1,155.90000000000003,1,2,1,4
17873,80,4,1514.63,2,4,3,9
17874,185,6,683.4600000000002,1,4,3,8
17877,170,1,237.61,1,2,1,4
17878,44,1,379.45,3,2,2,7
17879,174,1,178.51999999999998,1,2,1,4
17881,304,1,133.35000000000002,1,2,1,4
17883,3,4,664.34,4,4,3,11
17884,4,2,372.5499999999999,4,3,2,9
17885,12,1,156.34,4,2,1,7
17886,32,3,869.28,3,3,3,9
17887,129,1,111.35,1,2,1,4
17888,21,7,686.57,3,4,3,10
17889,212,2,201.37,1,3,1,5
17890,323,1,123.88000000000001,1,2,1,4
17891,162,1,203.85999999999996,1,2,1,4
17892,56,3,244.10000000000002,2,3,1,6
17893,225,1,107.21000000000002,1,2,1,4
17894,72,4,603.96,2,4,2,8
17895,44,1,95.44999999999999,3,2,1,6
17896,23,1,256.32,3,2,1,6
17897,173,1,131.14,1,2,1,4
17898,85,2,152.06,2,3,1,6
17899,159,1,154.55,1,2,1,4
17900,190,2,112.19999999999999,1,3,1,5
17901,29,1,110.38,3,2,1,6
17904,21,1,181.07,3,2,1,6
17905,71,2,406.09000000000003,2,3,2,7
17906,247,1,72.9,1,2,1,4
17911,9,1,366.23,4,2,2,8
17912,310,1,21.6,1,2,1,4
17913,59,1,190.59999999999997,2,2,1,5
17914,4,1,329.35999999999996,4,2,2,8
17917,45,2,227.87,3,3,1,7
17919,88,1,1304.0400000000002,2,2,3,7
17920,4,15,3444.54,4,4,4,12
17921,64,4,820.2299999999999,2,4,3,9
17923,282,1,207.50000000000003,1,2,1,4
17924,12,6,2683.5000000000005,4,4,4,12
17926,133,2,397.29,1,3,2,6
17928,45,2,184.46,3,3,1,7
17929,11,4,843.0,4,4,3,11
17930,36,5,1740.4799999999998,3,4,4,11
17931,134,2,408.36,1,3,2,6
17932,29,3,1331.57,3,3,3,9
17934,52,2,704.25,2,3,3,8
17935,138,2,142.89000000000001,1,3,1,5
17936,5,1,380.13,4,2,2,8
17937,9,5,2147.3399999999997,4,4,4,12
17939,160,1,99.14000000000001,1,2,1,4
17940,49,9,2152.1800000000003,2,4,4,10
17941,131,1,304.56,1,2,2,5
17942,8,1,77.50000000000001,4,2,1,7
17946,233,2,149.58,1,3,1,5
17947,37,1,176.67999999999998,3,2,1,6
17948,147,1,358.56000000000006,1,2,2,5
17949,1,43,56716.48,4,4,4,12
17950,72,1,219.03,2,2,1,5
17951,40,1,599.0400000000001,3,2,2,7
17954,5,10,2185.45,4,4,4,12
17955,199,4,557.3,1,4,2,7
17956,249,1,12.75,1,2,1,4
17957,66,1,110.72,2,2,1,5
17958,117,1,508.4599999999999,2,2,2,6
17960,171,1,73.78,1,2,1,4
17961,21,36,726.69,3,4,3,10
17962,142,1,102.41,1,2,1,4
17964,32,1,201.45,3,2,1,6
17965,38,12,2448.6400000000003,3,4,4,11
17966,38,5,1098.4299999999998,3,4,3,10
17969,166,1,103.0,1,2,1,4
17970,211,1,562.7900000000001,1,2,2,5
17972,242,1,135.19,1,2,1,4
17973,52,1,337.03999999999996,2,2,2,6
17974,25,3,703.99,3,3,3,9
17975,15,11,3858.4700000000003,4,4,4,12
17977,29,1,288.14,3,2,1,6
17979,36,4,729.01,3,4,3,10
17980,166,2,516.25,1,3,2,6
17984,145,1,152.68,1,2,1,4
17985,22,1,631.3499999999999,3,2,2,7
17986,56,1,20.8,2,2,1,5
17987,185,1,198.57,1,2,1,4
17988,12,7,201.11999999999998,4,4,1,9
17990,237,1,314.84,1,2,2,5
17991,225,2,93.35,1,3,1,5
17994,122,4,674.89,2,4,3,9
17995,282,1,76.1,1,2,1,4
17997,74,8,1962.46,2,4,4,10
17999,37,1,190.05,3,2,1,6
18001,12,2,415.13,4,3,2,9
18005,4,2,226.47,4,3,1,8
18006,23,1,444.68,3,2,2,7
18008,70,9,2116.19,2,4,4,10
18009,235,1,247.39000000000001,1,2,1,4
18010,257,1,174.79999999999998,1,2,1,4
18013,155,2,187.29,1,3,1,5
18014,28,1,154.27,3,2,1,6
18015,4,1,120.03000000000002,4,2,1,7
18016,32,4,1321.01,3,4,3,10
18017,81,3,523.0,2,3,2,7
18018,108,2,122.14,2,3,1,6
18019,52,1,38.45,2,2,1,5
18022,36,1,612.72,3,2,2,7
18024,153,2,389.78,1,3,2,6
18027,99,1,115.30999999999999,2,2,1,5
18030,4,2,230.64999999999998,4,3,1,8
18032,334,1,73.5,1,2,1,4
18033,65,1,93.82000000000001,2,2,1,5
18034,22,2,418.6799999999999,3,3,2,8
18035,36,3,713.8900000000001,3,3,3,9
18036,32,3,403.12000000000006,3,3,2,8
18037,154,5,38.720000000000006,1,4,1,6
18040,19,2,357.2,3,3,2,8
18041,12,18,3482.4800000000005,4,4,4,12
18042,54,1,165.04999999999998,2,2,1,5
18043,25,2,241.38,3,3,1,7
18044,4,9,2014.3500000000001,4,4,4,12
18045,45,1,178.33999999999997,3,2,1,6
18048,203,2,172.29000000000002,1,3,1,5
18053,71,1,300.0200000000001,2,2,1,5
18055,7,7,5010.219999999999,4,4,4,12
18056,288,1,363.65,1,2,2,5
18058,10,1,170.16,4,2,1,7
18059,23,3,306.46,3,3,2,8
18061,22,9,1714.25,3,4,4,11
18062,173,3,720.5200000000001,1,3,3,7
18064,133,2,814.0,1,3,3,7
18065,6,12,2047.8100000000002,4,4,4,12
18066,75,1,318.0,2,2,2,6
18067,40,1,396.33000000000004,3,2,2,7
18068,289,1,101.69999999999999,1,2,1,4
18069,26,5,2009.24,3,4,4,11
18071,258,1,194.05,1,2,1,4
18072,186,1,247.44,1,2,1,4
18073,114,12,3859.82,2,4,4,10
18075,23,9,2412.8,3,4,4,11
18077,8,9,2188.08,4,4,4,12
18078,217,2,336.13,1,3,2,6
18079,45,4,3613.1499999999996,3,4,4,11
18080,19,2,1231.5,3,3,3,9
18081,36,3,343.45,3,3,2,8
18082,26,1,680.8399999999999,3,2,3,8
18084,16,1,90.47999999999999,4,2,1,7
18085,330,1,386.04999999999995,1,2,2,5
18086,274,1,101.33999999999999,1,2,1,4
18087,291,1,3202.9199999999996,1,2,4,7
18088,61,1,166.02999999999997,2,2,1,5
18092,2,8,6215.620000000001,4,4,4,12
18093,93,4,2106.52,2,4,4,10
18094,82,7,3017.3,2,4,4,10
18095,313,2,580.05,1,3,2,6
18096,12,3,849.06,4,3,3,10
18097,8,5,2479.8800000000006,4,4,4,12
18099,127,1,168.31,2,2,1,5
18101,11,2,222.4,4,3,1,8
18102,1,56,231822.69000000003,4,4,4,12
18104,37,1,754.6400000000001,3,2,3,8
18105,38,1,113.48000000000002,3,2,1,6
18106,330,1,421.9,1,2,2,5
18108,254,1,271.0,1,2,1,4
18109,2,24,7452.169999999999,4,4,4,12
18110,20,1,198.8,3,2,1,6
18112,12,2,352.69000000000005,4,3,2,9
18114,290,1,220.1,1,2,1,4
18116,68,5,741.74,2,4,3,9
18117,26,1,314.3999999999999,3,2,2,7
18118,11,24,5017.92,4,4,4,12
18120,214,1,111.14999999999999,1,2,1,4
18121,149,2,653.3000000000001,1,3,2,6
18122,8,6,1791.8400000000001,4,4,4,12
18123,24,2,574.4399999999999,3,3,2,8
18125,30,4,1131.75,3,4,3,10
18126,61,1,198.58,2,2,1,5
18127,19,3,347.08,3,3,2,8
18129,243,1,112.55,1,2,1,4
18130,15,3,1059.3899999999999,4,3,3,10
18133,212,1,931.4999999999999,1,2,3,6
18135,29,5,681.9100000000001,3,4,3,10
18136,63,3,784.3299999999998,2,3,3,8
18138,295,1,152.65,1,2,1,4
18139,18,6,8438.34,3,4,4,11
18142,157,2,1019.52,1,3,3,7
18143,117,2,1000.1600000000001,2,3,3,8
18144,8,10,2386.1000000000004,4,4,4,12
18145,13,4,2861.55,4,4,4,12
18146,141,2,160.35,1,3,1,5
18147,46,2,179.33999999999997,3,3,1,7
18149,51,3,612.0799999999999,2,3,2,7
18150,32,3,566.5800000000002,3,3,2,8
18151,135,2,653.3499999999999,1,3,2,6
18154,3,2,399.18999999999994,4,3,2,9
18155,75,3,371.62000000000006,2,3,2,7
18156,13,1,488.76,4,2,2,8
18158,9,2,453.4,4,3,2,9
18159,301,1,530.1500000000001,1,2,2,5
18160,57,2,638.0600000000002,2,3,2,7
18161,15,5,1618.69,4,4,4,12
18164,37,1,399.65,3,2,2,7
18165,177,1,302.46000000000004,1,2,2,5
18167,23,3,1384.86,3,3,3,9
18168,176,4,710.1,1,4,3,8
18169,61,1,202.65,2,2,1,5
18170,33,3,980.3100000000001,3,3,3,9
18171,59,5,1231.31,2,4,3,9
18172,15,20,7561.68,4,4,4,12
18173,87,4,2106.8400000000006,2,4,4,10
18174,7,1,104.0,4,2,1,7
18177,31,6,1340.87,3,4,3,10
18178,129,3,1290.16,1,3,3,7
18179,9,6,1793.1700000000003,4,4,4,12
18180,5,6,1843.7500000000005,4,4,4,12
18181,24,1,366.84999999999997,3,2,2,7
18183,227,2,632.0700000000002,1,3,2,6
18184,15,1,49.8,4,2,1,7
18185,249,1,304.25,1,2,2,5
18188,15,3,2001.0399999999997,4,3,4,11
18189,78,2,1090.2400000000002,2,3,3,8
18190,192,2,284.46,1,3,1,5
18191,262,1,207.79999999999998,1,2,1,4
18192,72,1,957.9699999999999,2,2,3,7
18193,165,1,243.76,1,2,1,4
18194,82,1,973.8399999999999,2,2,3,7
18196,95,2,686.6300000000001,2,3,3,8
18198,4,17,5425.560000000001,4,4,4,12
18200,106,1,150.35,2,2,1,5
18202,200,3,1396.9900000000002,1,3,3,7
18203,157,1,160.42000000000002,1,2,1,4
18204,71,3,1975.35,2,3,4,9
18205,36,2,517.3599999999999,3,3,2,8
18209,29,1,139.10000000000002,3,2,1,6
18210,2,6,2621.38,4,4,4,12
18211,26,5,600.07,3,4,2,9
18212,326,1,216.07,1,2,1,4
18213,237,1,232.48000000000002,1,2,1,4
18215,89,1,299.34,2,2,1,5
18216,31,1,481.74999999999994,3,2,2,7
18217,29,2,621.7500000000001,3,3,2,8
18218,211,2,641.9200000000001,1,3,2,6
18219,3,8,1679.71,4,4,4,12
18220,227,1,305.28000000000003,1,2,2,5
18221,22,5,1041.6100000000001,3,4,3,10
18222,93,1,443.0,2,2,2,6
18223,5,13,5982.85,4,4,4,12
18224,264,1,158.95000000000002,1,2,1,4
18225,3,11,5474.960000000001,4,4,4,12
18226,44,11,5228.050000000001,3,4,4,11
18227,218,1,93.75,1,2,1,4
18228,57,2,779.9,2,3,3,8
18229,12,18,6623.7,4,4,4,12
18230,9,7,2810.1999999999994,4,4,4,12
18231,192,5,2071.7699999999995,1,4,4,9
18232,82,4,592.97,2,4,2,8
18233,326,1,440.0,1,2,2,5
18235,72,3,1796.4800000000002,2,3,4,9
18236,30,6,882.24,3,4,3,10
18237,3,5,987.1000000000001,4,4,3,11
18239,219,4,1123.51,1,4,3,8
18240,46,1,422.58000000000004,3,2,2,7
18241,10,17,2073.09,4,4,4,12
18242,72,4,2232.4900000000002,2,4,4,10
18245,7,6,2201.33,4,4,4,12
18246,24,2,596.0999999999999,3,3,2,8
18248,123,2,804.02,2,3,3,8
18249,17,1,95.34,3,2,1,6
18250,310,1,349.27000000000004,1,2,2,5
18251,87,1,4314.72,2,2,4,8
18252,51,2,518.27,2,3,2,7
18255,89,1,103.3,2,2,1,5
18257,39,8,2337.6300000000006,3,4,4,11
18259,25,2,1962.3000000000002,3,3,4,10
18260,173,5,2397.65,1,4,4,9
18261,43,2,324.24,3,3,2,8
18262,140,1,149.48,1,2,1,4
18263,26,3,1213.1599999999999,3,3,3,9
18265,72,2,801.5100000000001,2,3,3,8
18268,134,1,25.5,1,2,1,4
18270,38,2,283.15000000000003,3,3,1,7
18272,3,6,3078.58,4,4,4,12
18273,2,3,204.0,4,3,1,8
18274,30,1,175.92000000000002,3,2,1,6
18276,44,1,335.8599999999999,3,2,2,7
18277,58,1,110.38,2,2,1,5
18278,74,1,173.89999999999998,2,2,1,5
18280,278,1,180.6,1,2,1,4
18281,181,1,80.82,1,2,1,4
18282,8,2,178.05,4,3,1,8
18283,4,16,2039.5800000000002,4,4,4,12
18287,43,3,1837.2800000000002,3,3,4,10
